number_of_letters	last_letters	word_count	usage_score	en_count	et_count	en_words	et_words
3	ing	5105	0.01269	5043	62	regering,ting,udvikling,løsning,beslutning,befolkning,mening,forening,stilling,oplysning,behandling,udstilling,afdeling,erfaring,betydning,holdning,bygning,udfordring,forklaring,forhandling,forestilling,forventning,retning,forretning,investering,forskning,slutning,stigning,ændring,flygtning,vurdering,omsætning,undervisning,handling,anledning,stemning,turnering,ordning,modsætning,dronning,fortælling,ring,opbakning,lovgivning,træning,samling,omkostning,tegning,placering,forudsætning,generalforsamling,bekymring,regning,melding,forandring,erstatning,virkning,afslutning,ansøgning,henvisning,blanding,udlænding,afstemning,anbefaling,betragtning,meningsmåling,spænding,forbedring,folkeafstemning,åbning,indtjening,sammenligning,bemærkning,betaling,fagforening,opfordring,beretning,forvaltning,forsikring,målsætning,beregning,indstilling,efterforskning,underholdning,rådgivning,måling,erindring,finansiering,begejstring,scoring,erklæring,undskyldning,vejledning,lukning,tilknytning,begrænsning,sætning,læsning,kendsgerning,etablering,markedsføring,planlægning,forfatning,fortolkning,nedskæring,fyring,udmelding,renovering,høring,udledning,problemstilling,ligestilling,fremstilling,fordeling,forurening,dækning,styring,opvarmning,strækning,indretning,overvågning,satsning,bevilling,lønning,afsløring,udvisning,tilmelding,opløsning,beskyldning,opbygning,kylling,besætning,globalisering,føring,vending,indvandring,forsamling,stramning,tilslutning,overbevisning,prioritering,bekostning,regulering,håndtering,afhøring,opsætning,formulering,udbygning,doping,rengøring,udbetaling,afhandling,udstrækning,sammenslutning,ombygning,flytning,udskiftning,opstilling,opsparing,påvirkning,indsamling,belastning,cykling,overnatning,skildring,gerning,evaluering,klimaforandring,rygning,omlægning,viking,prisstigning,afvikling,orientering,sammensætning,bivirkning,afvisning,beskatning,sammenlægning,sagsbehandling,maling,tænkning,registrering,udlægning,formidling,forvirring,redning,indledning,levering,udformning,lønstigning,tvilling,omstilling,forhindring,læring,forhåbning,afklaring,foranstaltning,betjening,modernisering,indspilning,tilbagetrækning,forsyning,digtsamling,flyvning,privatisering,mobning,brugerbetaling,husholdning,hindring,svømning,bestilling,indblanding,lodtrækning,udveksling,timing,tolkning,aflevering,ledning,nedskrivning,servering,næring,spredning,slægtning,rundvisning,deling,borgerforening,forvandling,vandring,tilpasning,aktivering,anmodning,nytænkning,lancering,genopbygning,boksning,filmatisering,belønning,madlavning,opvisning,udlicitering,uddeling,sikring,indvending,boligforening,udgravning,familiesammenføring,justering,pensionering,belysning,oprydning,liberalisering,lærling,pensionsopsparing,genforening,oprykning,efterretning,markering,indberetning,udlejning,pasning,betænkning,søgning,omdrejning,anvisning,genoptræning,tilbygning,camping,omvæltning,honning,udsmykning,arving,effektivisering,marketing,fernisering,bedring,børsnotering,fordobling,opdeling,forelæsning,udstråling,påklædning,udligning,opklaring,børnepasning,nedrykning,parkering,antydning,gruppering,formodning,strømning,udredning,opdatering,rekruttering,fængsling,forsoning,forstærkning,drejning,eftersøgning,færing,startopstilling,gødning,afmatning,særudstilling,tatovering,udlevering,vinding,nedjustering,beundring,islænding,gensplejsning,udrensning,klimaændring,pokalturnering,forskelsbehandling,organisering,landing,digitalisering,indbetaling,opfølgning,spisning,berøring,forveksling,kobling,betalingsstandsning,mishandling,tildeling,stråling,restaurering,lokalbefolkning,fejring,socialforvaltning,småting,støtteforening,specialundervisning,belægning,kortlægning,undsætning,oplæsning,aflysning,statsforvaltning,åbenbaring,overbygning,tilstrømning,omstrukturering,nominering,dæmning,ernæring,ransagning,nedrivning,musling,opbremsning,forbrænding,udsending,screening,opbevaring,kunstforening,terning,lussing,optælling,sygesikring,afsætning,kåring,forordning,ytring,vælgerforening,udflytning,isolering,indvirkning,håndsrækning,handelsstandsforening,arbejdsformidling,indsprøjtning,fremtoning,forundring,mærkning,civilbefolkning,erobring,opringning,beholdning,implementering,eksponering,tilbagemelding,shopping,kommunesammenlægning,konstatering,produktudvikling,nævning,udstykning,koordinering,tilbagebetaling,tackling,binding,radikalisering,blødning,beklædning,indlæring,dressing,boring,fredning,forrentning,forankring,luftforurening,forenkling,hovedbygning,særbehandling,kursstigning,afbrænding,beskæring,terrorhandling,forløsning,befrugtning,vandforsyning,afskrivning,aflytning,afsoning,dyrkning,kidnapning,skabning,overhaling,grundejerforening,omskæring,konsolidering,oprustning,indpakning,afregning,forskydning,kreditforening,opstramning,fokusering,udforskning,afføring,novellesamling,afskygning,fjernbetjening,internationalisering,bemanding,digtning,rationalisering,sammenblanding,beskydning,sænkning,kending,skiltning,fæstning,historieskrivning,branding,genopretning,foranledning,landvinding,slagtning,opjustering,topplacering,byudvikling,nedbrydning,kvittering,annoncering,omfordeling,opmuntring,sprængning,skilling,prisudvikling,hensigtserklæring,ligning,happening,fordring,skydning,afstamning,halvering,centralisering,hjerneblødning,fællesspisning,videreudvikling,opgradering,henstilling,bombning,belejring,udrykning,ælling,harmonisering,ugerning,høvding,skæring,afpresning,bowling,scanning,grundforskning,industrialisering,demokratisering,urafstemning,julestemning,rensning,afslapning,videoovervågning,ensretning,afspærring,atomprøvesprængning,normering,optrapning,indskrænkning,devaluering,understregning,tælling,stævning,skråning,ombæring,rydning,kovending,krydsning,udstødning,sygemelding,visning,nedskydning,afprøvning,strålebehandling,opsplitning,fotografering,aflønning,elforsyning,likvidering,rehabilitering,rating,udstationering,grønning,opblomstring,forværring,killing,koalitionsregering,oprejsning,skolefritidsordning,indføring,tilberedning,nedsmeltning,afdækning,ridning,yngling,involvering,kloning,evakuering,sparring,forgiftning,svingning,swing,efterlysning,realisering,hentydning,opkrævning,overophedning,rivalisering,vejrtrækning,afvejning,fortrængning,leasing,grundholdning,fremskrivning,nybygning,lønforhandling,tiltrækning,affjedring,brydning,dumping,sammensmeltning,rørledning,kulegravning,udregning,roning,styrketræning,granskning,udskæring,polarisering,nationalforsamling,linjeføring,temperaturstigning,hædersbevisning,fremvisning,omskrivning,blomstring,forklædning,formaning,trosretning,opladning,afgrænsning,indkvartering,anretning,bearbejdning,indflytning,forplejning,skadevirkning,nedslidning,beplantning,ophængning,projektering,opsejling,vesterlænding,følgevirkning,præcisering,decentralisering,notering,indhegning,kælling,byplanlægning,brugsforening,ophobning,udvinding,trepartsforhandling,konvertering,risikovurdering,galning,smoking,indskoling,udvandring,overlevering,føling,kunstgødning,kassebeholdning,kamphandling,studieretning,livsforsikring,efterligning,klipning,lagring,riesling,samlingsregering,mellemting,forvikling,skævvridning,kærlighedserklæring,opsamling,krigshandling,yndling,rejseforsikring,oplæring,sansning,montering,stemmeføring,wing,begæring,forfriskning,reducering,afhentning,normalisering,smagning,nedtælling,frasering,specialisering,stabilisering,lederstilling,ønsketænkning,gidseltagning,sortering,indånding,vekselvirkning,pakning,stegning,opkomling,vidneforklaring,outsourcing,blåstempling,genoplivning,livserfaring,opblødning,tidsregning,indsmugling,førstebehandling,certificering,blokering,vanetænkning,mobilisering,fremrykning,ladning,egenbetaling,aflastning,bortvisning,redigering,bogføring,tinglysning,udsætning,udblæsning,støbning,kreditvurdering,udmøntning,underretning,udskrivning,opstigning,kyststrækning,folkevandring,hæmning,bosætning,bevaring,lappeløsning,forvisning,kopiering,kontorbygning,konstituering,fuldtidsstilling,optimering,afveksling,lovprisning,eftervirkning,skytteforening,konkursbegæring,plyndring,strafudmåling,booking,udpegning,opkvalificering,skrivning,genforhandling,presenning,brugsanvisning,dønning,forarbejdning,selskabstømning,jobsøgning,ping,nødløsning,genåbning,tinding,amning,menneskesmugling,casting,selvbetjening,messing,stening,spejling,mægling,sangskrivning,fødeafdeling,revalidering,kortslutning,vildledning,profilering,fremtidsforskning,bortforklaring,brevveksling,sanering,bevogtning,ørkenvandring,doktorafhandling,valghandling,modregning,afløsning,genrejsning,kapring,vrangforestilling,gældsætning,tilvænning,trækning,voldshandling,opremsning,driftsomkostning,briefing,budgetlægning,overdækning,islamisering,afvænning,falliterklæring,lægeerklæring,rundringning,udluftning,isterning,legalisering,aflivning,intensivafdeling,bevoksning,hvidvaskning,formgivning,udløsning,specialforretning,indespærring,programmering,døråbning,telefonregning,sending,brænding,generalisering,forvaring,forfalskning,afkøling,betoning,beværtning,kursændring,dribling,udrustning,fatning,hældning,syning,pakkeløsning,saltvandsindsprøjtning,servostyring,ansigtsløftning,holdopstilling,efterdønning,krigserklæring,rapportering,jobtræning,løbetræning,snerydning,dramatisering,vejspærring,fraflytning,fortrøstning,aldring,kuling,dykning,særling,piercing,mellemlanding,opmåling,gældssanering,topstyring,højtlæsning,lykønskning,kommercialisering,omvisning,lovning,rejsning,telefonaflytning,kammusling,gnidning,nedrustning,åreforkalkning,instrumentering,overbelægning,curling,genindspilning,boligsikring,smugling,oprensning,folketingssamling,afspænding,tredobling,læresætning,konfliktløsning,grænsedragning,kønsfordeling,knipling,fletning,sprængladning,afsmitning,kvalitetssikring,prissætning,patruljering,opgaveløsning,opkastning,hvælving,prøvetræning,bådflygtning,medicinering,skudveksling,kolonisering,lysning,forædling,nyhedsformidling,vinsmagning,bombesprængning,gearing,marginalisering,kriminalisering,tyrefægtning,kystsikring,programerklæring,anmærkning,opdækning,datering,indsejling,årsomsætning,nationalisering,navneforandring,mudderkastning,nedslagtning,befaling,stikning,afbureaukratisering,foræring,sightseeing,sperling,individualisering,vægtning,inddeling,dosering,tænding,patientforsikring,kassetænkning,roadpricing,nyfortolkning,fastfrysning,stigmatisering,boksering,tømning,tilsætning,underernæring,værdistigning,gendigtning,aflejring,anordning,sondering,uddybning,healing,automatisering,vælgertilslutning,piratkopiering,olding,nedtrapning,kloakering,trykning,modning,udladning,akkreditering,sondring,gisning,efterbehandling,fægtning,revurdering,sundhedsforvaltning,udklædning,motivering,deponering,standsning,skumring,nedprioritering,forgrening,ligebehandling,udhuling,kuldegysning,stikling,rustning,bagning,fodring,professionalisering,overflytning,annektering,konkurrenceforvridning,omskoling,indskrivning,brandslukning,spærring,ordveksling,bueskydning,affyring,schilling,sammenkædning,ringridning,ansvarsforsikring,tæring,udbringning,ordrebeholdning,overbelastning,tilflytning,gardering,slægtsforskning,afskærmning,sammenstilling,visualisering,afsmeltning,ofring,bilforsikring,mødding,degradering,diskriminering,gennemlæsning,badning,udbedring,seedning,forsikringsordning,aftapning,forbrødring,politisering,eskalering,nedkøling,gæring,retskrivning,halshugning,særstilling,ræling,røgforgiftning,genfortælling,byggemodning,omklædning,sæsonafslutning,sammenkobling,landbefolkning,folketælling,omprioritering,afklapsning,forstrækning,belæring,plantning,shipping,ulykkesforsikring,catering,fældning,urbanisering,krisestyring,brandforsikring,afspejling,relancering,overbetaling,benådning,afbildning,skrotning,bogsamling,påvisning,diagnosticering,lindring,trilling,vanding,tredeling,punktering,højredrejning,olieforurening,topstilling,kogning,problemløsning,tøndeslagning,forbinding,krusning,indboforsikring,pejling,håndværkerforening,hævning,landevejscykling,træfning,omrøring,voksenundervisning,dæmonisering,varsling,sammenfatning,tobaksrygning,favorisering,hængning,tøjforretning,vindretning,fordrejning,sindsstemning,kroning,afspadsering,parring,fordybning,juleafslutning,dobling,blåmusling,brobygning,standardisering,rømning,belåning,promovering,gambling,udskænkning,skatteomlægning,polstring,fejlslutning,bedding,bespisning,stavning,reorganisering,knopskydning,krisestemning,nødlanding,barbering,elektrificering,sammentrækning,hormonbehandling,fintælling,kryptering,surfing,afvæbning,omdeling,tilsvining,befordring,vielsesring,aflæsning,nyhedsdækning,forstening,afmærkning,udbytning,sekularisering,vævning,differentiering,fejlvurdering,spaltning,stemmeafgivning,navngivning,tørring,indoktrinering,udlodning,bloddoping,detailstyring,forevisning,risikostyring,udskoling,publicering,bundplacering,vinkling,naturgenopretning,dating,lemming,samsing,mandsopdækning,kørestilling,fordampning,møbelforretning,sprøjtning,omorganisering,livsholdning,overfladebehandling,stimulering,overbefolkning,tidsbegrænsning,hovedrengøring,afledning,groning,skoling,pærevælling,bisætning,tronarving,opkobling,pressedækning,forvrængning,forhøjning,overbelåning,omrokering,dumpning,kattekilling,ombytning,præstegerning,udmunding,søforklaring,udvaskning,forpagtning,udvanding,afbetaling,klargøring,radering,kvælning,konservering,kønskvotering,indsnævring,kulturformidling,bådudstilling,opsummering,grævling,energimærkning,oppakning,fiksering,klatring,principbeslutning,afspilning,hacking,selvudvikling,servicering,annullering,genhusning,isolationsfængsling,efterbetaling,overflyvning,rangering,fejlaflevering,bjergbestigning,opvågning,skiskydning,votering,flertalsregering,krampetrækning,brystsvømning,befæstning,navneændring,børneopsparing,fredsslutning,nedvurdering,forplantning,opskrivning,slagterforretning,kildehenvisning,øgning,minerydning,helhedsløsning,legitimering,adgangsbegrænsning,socialisering,udtørring,karaktergivning,videndeling,pengeafpresning,køling,hudafskrabning,låntagning,deregulering,munding,kreditgivning,fejlbehandling,opprioritering,skovrejsning,fordanskning,formning,eksilregering,teambuilding,personificering,støvsugning,tekstbehandling,andenbehandling,omklamring,nuancering,styling,ratificering,limning,fundraising,indflyvning,grundsætning,formering,vidneafhøring,påtegning,afvaskning,restrukturering,opfyldning,indføling,afsøgning,revidering,smertebehandling,underminering,efterrationalisering,indbildning,rumforskning,udrulning,afskedsbegæring,nærlæsning,armbøjning,undervisningsdifferentiering,lysregulering,jernbaneoverskæring,klassificering,bestråling,domsforhandling,opsporing,udsmidning,igangsætning,udsugning,enhjørning,frispilning,skattetænkning,resocialisering,cirkusforestilling,centring,sampling,bestalling,afrapportering,suspendering,fundering,vandladning,skadeforsikring,långivning,hedning,rygdækning,optøning,indskiftning,samordning,affolkning,genetablering,pendling,forvridning,græsning,returnering,rolling,spidsbelastning,vandledning,modstilling,voksenlærling,fortæring,rationering,hovedregning,afrunding,krumning,affaldshåndtering,legering,oplagring,udskridning,svejsning,nedstigning,blodforgiftning,vægtløftning,nulløsning,tidsbestilling,afsporing,børnemishandling,pladesamling,intimidering,fibersprængning,heling,idéudvikling,vandreudstilling,indkøbsforening,tredjebehandling,smertelindring,overskæring,budding,tandbørstning,æresbevisning,nedgravning,nøglering,lakering,sammenstyrtning,brugsting,påpegning,pladsanvisning,såning,borddækning,amerikanisering,fremtidssikring,afstøbning,ophugning,undervurdering,opgravning,perspektivering,håndfæstning,pusling,indlevering,kategorisering,bøjning,alsing,maskering,grundstødning,forsvinding,lytning,udeservering,stensætning,børnetegning,familieplanlægning,overspringshandling,testning,soling,partikelforurening,nedtagning,studievejledning,refinansiering,udtynding,afhjælpning,finpudsning,anprisning,udtrækning,internering,dræning,humørsvingning,festforestilling,eksekvering,aftrapning,rammefortælling,positionering,indefrysning,tydning,tidtagning,simulering,køreledning,overlapning,madding,sterling,disponering,indkøring,forudbetaling,forudbestilling,selvforsyning,møblering,brandsikring,åring,nedgradering,ægløsning,bodeling,kønsforskning,udsultning,knibning,rokering,indramning,soning,windsurfing,slukning,fjernundervisning,højspænding,farvning,sportsforretning,braklægning,installering,bestøvning,magtfordrejning,bredning,piskning,saltning,kropsbygning,symptombehandling,hovsaløsning,krydring,fortøjning,selvpromovering,stuvning,krisehåndtering,gennemspilning,historieforfalskning,gamling,kaskoforsikring,kunstvanding,wrestling,tegnsætning,niveaudeling,åreladning,vejning,nedfrysning,programlægning,sidebemærkning,nyordning,generobring,samkøring,personskildring,partshøring,dehydrering,versionering,aftegning,stempling,langtidsvirkning,integrering,indvinding,skattesænkning,vejrmelding,genopsætning,tilbagelægning,dimensionering,bugsering,udskilning,inddæmning,selvovervurdering,sociallovgivning,syltning,eftersidning,omstigning,skåning,kodning,blindsmagning,håndevending,sangforening,bodybuilding,helsekostforretning,celleforandring,sammenføjning,stikledning,feberredning,tildækning,genoptrykning,helleristning,omkalfatring,ajourføring,gennemstrømning,brolægning,statusopdatering,fakturering,spraymaling,fedtsugning,flykapring,sektorforskning,afvandring,modellering,byrdefordeling,skønhedsdronning,blomsterforretning,overskudsdeling,intensivering,lokalisering,standerhejsning,slibning,heltegerning,sagsfremstilling,forfrysning,bevæbning,udsivning,databehandling,skovrydning,sædeskildring,opdyrkning,repatriering,fingerring,brygning,forstuvning,bjergning,misfarvning,benchmarking,honorering,udmåling,nedbremsning,runding,krøbling,trekking,præmiering,udpumpning,udplantning,ghettoisering,visitering,patentering,ibrugtagning,rådslagning,jernring,skynding,køkkenmødding,kvalitetsstyring,slagtekylling,bemaling,fejlfortolkning,lagerbeholdning,rafting,uddelegering,mundering,armlægning,strikning,fragmentering,ranking,fartbegrænsning,tapning,eliminering,afvanding,retsvirkning,forvanskning,underbetaling,støjdæmpning,forsimpling,optræning,nedstyrtning,sidebygning,filtrering,forkalkning,destabilisering,forlovelsesring,årring,bureaukratisering,disciplinering,dobbeltbeskatning,tyverisikring,undergravning,efterbevilling,deltidsstilling,lavning,hamstring,tumling,prøvesmagning,kørselsretning,afholdsforening,uniformering,hvervning,udjævning,udplyndring,urbefolkning,øremærkning,kunstretning,træfældning,forgyldning,fårekylling,nedlægning,oliemaling,afkobling,ligbrænding,nedkastning,begravelsesforretning,clearing,signalforvirring,drukning,mistillidserklæring,efterisolering,afhopning,nedsivning,celledeling,realitetsforhandling,vægring,smøring,kvoteordning,afpudsning,indtastning,solskoldning,skriveblokering,pløjning,ridebanespringning,fyldning,søsætning,retsforfølgning,optrevling,fremlægning,intervaltræning,sammenskrivning,orkestrering,hashrygning,udslusning,rangordning,tilretning,enkedronning,forlægning,prægning,omplacering,afmontering,levning,afkortning,fortætning,lejerforening,biting,førtidspensionering,proportionsforvrængning,krængning,graduering,afklædning,indmelding,genforskning,indbinding,indfangning,indhentning,fugleskydning,saling,kombinationsbehandling,slankning,glidning,tæmning,varmebehandling,strygning,lynchning,iltning,trimning,indvejning,sporing,kanonisering,forhaling,frimærkesamling,forsuring,spanking,midterplacering,ising,farvelægning,overfortolkning,blomsterbinding,påfyldning,revitalisering,seksualisering,indstudering,reformering,konkretisering,grønskolling,bybefolkning,stænderforsamling,tivolisering,spisevægring,linning,konfirmandundervisning,smeltning,tilsløring,gradbøjning,udtagning,plukning,diamantring,svækling,forsnævring,misgerning,udflagning,tandlægeregning,afregulering,stranding,ætsning,kvalificering,drømmetydning,podning,afdæmpning,kremering,fermentering,aldersspredning,erhvervsvejledning,sletning,malkning,dyrtidsregulering,dæmpning,privatundervisning,forsegling,ruteflyvning,karriereplanlægning,kvægbesætning,losning,udposning,afgræsning,sammentælling,optankning,rekognoscering,afskovning,gødskning,konsekvensberegning,baggrundsstråling,europæisering,klædning,fritvalgsordning,afrensning,omregning,genlæsning,ommøblering,stregtegning,tangering,supplering,overvurdering,krigsmaling,tvangsbehandling,blodansamling,fosterstilling,miljømærkning,sammenfletning,udsoning,retsbelæring,kostvejledning,porcelænsmaling,panorering,langtidsplanlægning,delikatesseforretning,patentløsning,venstredrejning,nedrakning,hovedsætning,vælling,vejføring,mønstring,gennemtæring,græsslåning,identificering,synkronisering,forkastning,alkoholbevilling,afkriminalisering,institutionalisering,gallaforestilling,indslusning,tekstning,reetablering,bestigning,mandsling,pligtlæsning,udånding,tagdækning,romantisering,skadeserstatning,interessemodsætning,regeringsbeslutning,aptering,mekanisering,jogging,afbalancering,indregistrering,frasortering,nedkæmpning,idealisering,strukturering,nyvurdering,panering,arkivering,fleksjobordning,efterregning,naturfredning,langtidssygemelding,kameraføring,glorificering,halsudskæring,pensling,indstigning,selvfremstilling,finjustering,bouillonterning,afskalning,afgiftning,ordstilling,gennemskrivning,nedsabling,påsejling,topping,ringning,afkodning,underbemanding,indløsning,laserbehandling,omformning,femdobling,omtælling,familierådgivning,tovtrækning,stilisering,akademisering,luftning,udskibning,kønsopdeling,sprogforbistring,helgardering,imprægnering,kønsbehåring,falstring,dragning,skrædderstilling,problematisering,nedbrænding,afbestillingsforsikring,hjertemusling,lønregulering,støjmåling,hjemmefødning,sammenføring,jævning,lånefinansiering,omplantning,spiring,pebling,opmagasinering,kompostering,snoning,brisling,ekspropriering,overspisning,shilling,fastlåsning,udstigning,backing,frysning,forventningsafstemning,sløring,konfliktforskning,overmedicinering,jonglering,lægning,vanskabning,roaming,oprulning,luftspejling,afskæring,opslutning,omvending,akrylmaling,karakterisering,fejlmelding,opregning,brevskrivning,firling,møntsamling,springning,detailprojektering,indplacering,datomærkning,lynchstemning,drapering,kæntring,gæsteforelæsning,armering,gestaltning,væring,polering,vækning,kapitalisering,støjforurening,udfyldning,overstregning,opnormering,mindeudstilling,opfedning,nyplantning,rodbehandling,tilplantning,mavebøjning,bibellæsning,elevsammensætning,begrebsforvirring,nedtoning,indrykning,alarmering,fjernstyring,gipsafstøbning,fejllæsning,drageflyvning,overdosering,regnskabsføring,hjernevinding,afstivning,inddækning,opskæring,cementering,terminalbygning,indkredsning,overvintring,rørføring,tolærerordning,bremsning,kitesurfing,presning,opretning,ansamling,tuning,kontantbeholdning,desorientering,forcering,partering,negligering,mangedobling,overfiskning,moderbinding,budgettering,optjening,produktplacering,flugtning,gravning,overføring,demontering,hulning,portrættering,underlægning,tilkobling,stationering,kommatering,adfærdsregulering,planløsning,alminding,livsarving,opvartning,formening,skævdeling,spareskilling,coating,omvurdering,iklædning,kropsvisitering,kvotering,mentaltræning,brændemærkning,tilskæring,nøgenbadning,sandblæsning,tidobling,brandbeskatning,kurssikring,kønsdiskriminering,splejsning,bandlysning,debriefing,afkolonisering,forlængerledning,revaluering,gennemlysning,tilvirkning,afbestilling,flagning,tuschtegning,pirring,moralisering,kontraktstyring,stilretning,forsiring,harekilling,bagatellisering,kollektivisering,blegning,manipulering,pointering,indkapsling,postering,misstemning,landsætning,fusionering,minimering,sidestilling,hulahopring,hudfletning,nedblænding,indtrængning,stavnsbinding,asfaltering,medskabning,hanekylling,lastning,charterflyvning,regionalisering,monopolisering,assimilering,tilrettelægning,understyring,opredning,befamling,rygsvømning,slåning,ledsætning,detaljering,misvisning,ældning,modforanstaltning,filtning,strafforfølgning,valgstedsmåling,rygeafvænning,afmelding,foderblanding,modestrømning,overmaling,lugning,sprogforskning,namedropping,motorisering,lysvirkning,plagiering,svæveflyvning,udhængning,forskudsregistrering,veksling,headhunting,genspejling,fejltolkning,bodystocking,oparbejdning,synkronsvømning,mobilbetaling,retshandling,beslutningstagning,modtagning,konfiskering,afterskiing,rudeknusning,personlighedsspaltning,indregning,kystbevogtning,trossætning,fjæsing,kalkning,opfriskning,midterskilning,dåbshandling,overfakturering,fejlfinding,afblomstring,systematisering,tematisering,iblanding,badering,prøvning,formalisering,djøfisering,raffinering,seksualoplysning,bruning,tæppebombning,æglægning,kursivering,rundbarbering,førerstilling,inkorporering,forvitring,knæbøjning,sterilisering,straffeforanstaltning,udpining,rumflyvning,æresoprejsning,ringmærkning,skylning,affotografering,afskydning,optænding,lystlæsning,telemarketing,øvning,gentrificering,indgravering,hærdning,indsugning,behåring,afskibning,tankning,sponsering,brainstorming,popularisering,tabuisering,overstyring,besejling,kalibrering,ristning,stilforvirring,kattedronning,egnsudvikling,anonymisering,tandregulering,efterslukning,skattefinansiering,rammebevilling,ferielukning,fygning,ætling,tilgroning,tilbudsgivning,pudsning,indeslutning,påstigning,kædeforretning,fortynding,grødeskæring,sumobrydning,glatstrikning,kaproning,bøsning,halalslagtning,validering,fejning,tilbageføring,gæsling,anskydning,maskinskrivning,flydespærring,komprimering,kultivering,sløjfning,afrustning,slyngning,sambeskatning,røgning,genopstilling,dekantering,pornoficering,gennemsøgning,subsidiering,indfatning,indeksering,fabulering,homogenisering,strukturrationalisering,brevsamling,opmærkning,nedgøring,genopblomstring,nytegning,æstetisering,nivellering,beverding,hvilling,opbinding,mytologisering,indbygning,forflytning,tvangsfodring,krydsklipning,hjemtagning,segregering,reklamering,rulning,marmorering,besjæling,afrusning,udtømning,allokering,pålæsning,sydlænding,skyggeboksning,byggeforening,skibssætning,underbygning,sublimering,udpakning,væskeansamling,reservering,tiltalerejsning,emballering,uting,lagdeling,aftjening,skilning,nyttevirkning,udpensling,turnusordning,udradering,omgruppering,fritstilling,merindskrivning,gennemsejling,lodning,følgeslutning,toning,gentænkning,hulmursisolering,kabellægning,klatskilling,cirkelslutning,himmelhvælving,idyllisering,retstavning,kvælstofudvaskning,nummerering,genudlejning,grovsortering,manøvrering,cutting,nulstilling,indstrømning,systemtænkning,aktualisering,indlogering,frostsprængning,retardering,armvridning,erindringsforskydning,røgring,markvandring,gravering,prædikensamling,afhugning,himmerlænding,skibsladning,aftørring,segmentering,parallelparkering,skovning,raskmelding,overrisling,tipning,ørkenspredning,pyntning,tætning,tilrettevisning,husgerning,brugsvejledning,rivning,ornamentering,boliganvisning,udstrømning,skifting,velgerning,peeling,infiltrering,frastødning,relativering,penselføring,sminkning,brugervejledning,sammenplantning,forbytning,desertering,genvinding,selvspejling,kommentering,genopfriskning,foldning,feminisering,brutalisering,fejlplacering,kommunalisering,skamfering,halvtidsstilling,omformulering,udviskning,pansring,pervertering,banalisering,hækling,overeksponering,herreekvipering,påføring,afsondring,sortlistning,salatdressing,omsmeltning,klimamålsætning,forbehandling,udgrænsning,sammensyning,forspiring,genopladning,atomsprængning,dialysebehandling,indlæsning,effektuering,ringeagtsytring,forfordeling,prøvetagning,gammastråling,krakelering,kastrering,marionetregering,toldbehandling,knusning,sammenknytning,kristning,dehumanisering,kulfyring,tilskrivning,pilotering,indianerhøvding,køreretning,navigering,fastspænding,inkludering,flugtskydning,ekskludering,tilvandring,bytning,mørkning,kickboksning,universalløsning,opformering,indpasning,tilspidsning,instrumentalisering,fogedforretning,desavouering,leding,distancering,lyddæmpning,skygning,omfortolkning,lygteføring,afblæsning,kraftudladning,fremføring,vejbygning,sikkerhedslanding,censurering,vedhæftning,opbagning,skråparkering,klaring,skravering,gesvejsning,afkrydsning,perforering,neutralisering,lønglidning,indtaling,opstemning,rigning,indtjekning,timebetaling,skemalægning,færdighedsregning,dissekering,medieforskning,gnalling,lapning,pantsætning,genindvinding,udretning,drikning,tjenestemandsstilling,journalisering,udspaltning,fraternisering,hastebehandling,klarmelding,murerlærling,sekventering,plenarforsamling,isenkramforretning,afpolitisering,akkumulering,drivning,processtyring,katalogisering,opstaldning,støjafskærmning,udklækning,transformering,flytteforretning,factoring,frilægning,firdobling,grusgravning,dalsænkning,afkalkning,flodmunding,børnesikring,tredjegradsforbrænding,udfletning,arbejdsvægring,opfostring,housewarming,eftertackling,bagbygning,socialforskning,prismærkning,overhøring,omladning,retledning,orddeling,makulering,modificering,sjipning,barndomserindring,fortegning,nednormering,kørselsvejledning,degenerering,opbrydning,ignorering,staffering,kvælstofforurening,revling,tolvmandsforening,refleksredning,simplificering,underordning,afstribning,tvangsarving,ordinering,misfortolkning,gasning,tøndring,erodering,inseminering,overfusning,sjælevandring,kreditoplysning,skærising,vridning,knivmusling,genoprustning,accentuering,kreditering,maveforgiftning,balkanisering,udsejling,sammenvoksning,sanktionering,tilsanding,oplægning,skoldning,samtidsorientering,forskansning,eneundervisning,rustbehandling,venteafdeling,treåring,raceblanding,bagbeklædning,liveindspilning,mætning,galvanisering,begroning,roadracing,frihåndstegning,indfarvning,dobbelteksponering,vandføring,lynghonning,atomisering,kannibalisering,demaskering,afstresning,servietring,optegning,afretning,anlægning,pausering,frankering,mavelanding,landkending,tygning,overbooking,mistolkning,overtræning,blækregning,framelding,nedsænkning,faderbinding,hårfjerning,blodstyrtning,balancering,frugtsætning,spinding,todeling,domesticering,trøstespisning,selvmedicinering,traumatisering,miskreditering,naturgødning,isætning,udspredning,tilsmagning,pigmentering,tilsmudsning,lotusstilling,psykologisering,invalidering,proviantering,ophedning,uddunstning,takling,tørlægning,omdefinering,blænding,begynderundervisning,fejldisponering,adling,intellektualisering,proletarisering,overdramatisering,maksimering,billettering,afmagring,udskamning,pottetræning,snowboarding,landmåling,deportering,sammenklipning,børnebegrænsning,brandskatning,kanalisering,franchising,powershopping,trivialisering,patinering,nødforanstaltning,stalling,signering,opblanding,ansporing,destillering,afsyngning,afstødning,arbejdsanvisning,afstrømning,andengradsligning,overfodring,forskalling,børneparkering,opdæmning,fredsforskning,forkortning,researchafdeling,maltraktering,grundvandssænkning,udfladning,decimering,materialisering,glasering,indblæsning,afdrypning,balsamering,påsætning,marinering,regionplanlægning,udkobling,ideologisering,udtoning,associering,kostumering,servereturnering,melodiføring,salving,afmytologisering,refundering,tapetsering,udspionering,korrumpering,udskrabning,tegngivning,cupturnering,pligtaflevering,afgasning,usling,afkristning,whistleblowing,anfordring,omveksling,statsforfatning,oppustning,legetøjsafdeling,gruppelivsforsikring,verificering,chokbehandling,samsending,krigsskadeserstatning,rejekælling,rafling,afbøjning,seksdobling,amputering,tykning,kommunalforvaltning,realitetsbehandling,snifning,udsmugling,foring,bibetydning,modfortælling,brøkregning,facilitering,livsstilling,vandalisering,forfølgning,blotlægning,tvedeling,indstråling,nazificering,generering,udpantning,vikling,førstegangsaflevering,forbistring,taxaflyvning,kuldsejling,pælesidning,citering,rundering,distribuering,forblødning,normalfordeling,mundaflæsning,diversificering,pladsbestilling,gydning,spuling,delegering,skrælning,klækning,brancheglidning,overblænding,formæling,petting,optagning,mildning,finkæmning,ritualisering,udspilning,mindskning,isning,teoretisering,reinvestering,retouchering,eftersynkronisering,kiming,bidering,afisning,suppeterning,teknologisering,afluring,smagsretning,kæltring,dødning,overtegning,fiktionalisering,alfabetisering,æltning,tilstopning,ombrydning,icing,bugtning,dampning,indlejring,helsætning,udskylning,opfodring,frakobling,lejring,rubricering,nedsparing,understøtning,tonesætning,omregistrering,understrygning,signalering,ligedeling,plombering,omdirigering,måleraflæsning,klausulering,kvantificering,venneanmodning,demilitarisering,skiftning,sammenklumpning,demoralisering,tækning,bristning,stabelafløbning,kildesortering,bidronning,andengradsforbrænding,toplønning,oxidering,indsætning,systemdigtning,overisning,strangulering,ørenring,underskrivning,studsning,tvangsudskrivning,forplumring,dekorering,detronisering,heltidsstilling,udlugning,overrumpling,udblødning,homeshopping,dæmring,humanisering,afslibning,afrydning,beføling,terrorisering,nakkefoldsscanning,celebrering,hønsering,kølhaling,tankeoverføring,skyggeregering,civilisering,talehandling,hegning,beluring,iling,kutling,postopkrævning,smedning,materialesamling,centrifugering,rappelling,økonomisering,flambering,grunding,quisling,troppeopbygning,skitsering,grebning,akvaplaning,fræsning,garnering,omringning,pumpning,blodudtrædning,grundforbedring,kondensering,aflusning,rørlægning,desillusionering,garvning,kontaminering,underbudgettering,beflyvning,aldersdiskriminering,udskældning,gering,inhalering,fremhævning,nøglestilling,intimbarbering,akklimatisering,tagrygning,grillstegning,sammenbinding,iblødsætning,langtidsstegning,amortisering,sammenstykning,konsumering,turboladning,sejlføring,udstopning,toåring,becifring,afmystificering,omprogrammering,klarlægning,sejlretning,krydshenvisning,fortidslevning,gennembrydning,delbetænkning,afgravning,lodsning,tandfyldning,deployering,fugning,gratinering,smitteopsporing,særbeskatning,skeetskydning,pasteurisering,omskiftning,forsænkning,dybdeboring,henkogning,indskæring,kupering,kurtisering,fejlsøgning,gennemtænkning,aflukning,neddykning,færdigbehandling,dagsbefaling,deformering,fremlysning,ompostering,nidding,indordning,indfrysning,opspænding,gennembankning,skrælling,talbehandling,flerdobling,forkrøbling,vejmelding,pendulering,sætningsbygning,demobilisering,malerlærling,sammenpresning,affodring,simultantolkning,saligprisning,taksering,fribrydning,opsugning,kostforplejning,filmforestilling,formuefordeling,alkydmaling,pacificering,isskruning,fortoldning,gennemblødning,udspørgning,omtolkning,restituering,opskalering,ciselering,rentesikring,sammensvejsning,penning,diskvalificering,indvarsling,postkvittering,korttidsparkering,midterstilling,målformulering,initiering,dublering,indsmøring,gunstbevisning,dobbeltbinding,forlening,kabelføring,spejlvending,styrtblødning,overspænding,vaccinering,fotokopiering,kværkning,afblegning,giroindbetaling,regenerering,gennemføring,finlandisering,udsondring,heroisering,smadring,landsplanlægning,overfladespænding,afmilitarisering,defibrillering,soignering,jordstråling,indtagning,søvnforskning,afladning,genmodificering,blåhvilling,berigning,seponering,helseforretning,hedestigning,læseforskning,bestykning,omstyrtning,afdampning,antænding,bedækning,sikkerhedskopiering,tredjeinstansbevilling,sugning,udprintning,vitalisering,separering,agerdyrkning,vulgarisering,randbemærkning,faring,kløvning,husning,skrabekylling,underføring,børstning,sidehenvisning,fading,hvidevareforretning,forsumpning,integralregning,schattering,dubbing,udfældning,slamsugning,hårfarvning,fødselsafdeling,reaktivering,føderalisering,knytning,headbanging,affejning,samlæsning,slotsaftapning,russificering,bæring,korrigering,differentialregning,sparkstøtting,forgasning,vandbygning,håndgerning,passivisering,formaling,voltigering,kaprustning,afindustrialisering,gennembladning,kontering,afsvaling,eksemplificering,motorring,indvikling,friturestegning,dechifrering,femling,mumificering,overbemanding,rasering,adressering,udbening,nedfældning,telefonering,gennemarbejdning,udrugning,ergometerroning,signetring,dagning,løfting,afpatruljering,renskrivning,rentegning,tillempning,indlægning,indtegning,bortlodning,navneforskning,tobaksafvænning,udglatning,bagklædning,overspilning,besegling,operationalisering,desinficering,ekvipering,undring,sammenstuvning,fantomredning,heksering,perspektivtegning,braisering,skønsforretning,præparering,lutring,skrumpning,vansiring,genvurdering,bogstavering,udmugning,rugning,deklassering,outing,torpedering,blødgøring,ordudveksling,afnazificering,sammenrotning,krympning,hospitalisering,karrierestilling,skopudsning,delløsning,programsætning,ombetrækning,tilbagekobling,udskydning,afstigning,lagerføring,gennemprøvning,saldokvittering,totalfredning,syrning,skalering,lavering,genkristning,selvpensionering,manifestering,definering,skiftesamling,afstøvning,kassering,udringning,lavspænding,blinding,gennemregning,flåning,periodisering,krystallisering,efterspænding,skibsproviantering,viktualieforretning,armstrækning,hundesvømning,afbødning,modelflyvning,omkodning,firepartiregering,parafrasering,udkrystallisering,modulering,fireåring,sproghandling,omlæsning,opvurdering,diskontering,babysitning,opsøgning,absorbering,gravsænkning,inficering,fouragering,brystspænding,medbetydning,natsænkning,taktregulering,savning,objektivisering,afhøvling,frysetørring,udstregning,ånding,hjemmebrænding,kransenedlægning,parallelisering,terminsforretning,bibemærkning,minesprængning,spontanflygtning,skrinlægning,tildigtning,pålægning,gennemtrawling,skibinding,kalkering,nedskalering,campering,sprøjtestøbning,processering,deaktivering,hejsning,hakning,relativisering,stabling,temperering,aflåsning,forkromning,proportionering,overbrusning,langtidsopbevaring,redobling,strandfodring,tærskning,brugerfinansiering,mandjævning,rendyrkning,formelsamling,skandalisering,synstolkning,minering,kompromittering,frostsikring,måltagning,universalarving,koncentrering,yderbeklædning,hyring,opstamning,fortyskning,dyndsmerling,udmaling,hyldning,kantning,bemestring,låsning,hjertestyrkning,surring,potensering,undergerning,fasankylling,blisterpakning,sindsforvirring,størkning,redefinering,besudling,patronisering,brøndboring,påsmøring,indkogning,indtørring,specificering,dobbeltstilling,udtænkning,retstrikning,afventning,profboksning,kælvning,gennemhegling,hierarkisering,afskrabning,vagabondering,ventilering,sammenhobning,indsivning,høstning,findeling,etikettering,neddæmpning,taleundervisning,blanchering,jamming,fraktionering,brystning,projicering,anflyvning,bevikling,stjernetydning,skimming,bosondring,reevaluering,forsølvning,laminering,underprioritering,afsyring,renvaskning,saftspænding,underafkøling,idolisering,oliefyring,opklodsning,skoleridning,internalisering,diegivning,opstabling,fladsyning,kondemnering,paraglidning,tilbagedatering,magnetisering,gennemtrængning,arrangering,tekstanmærkning,objektivering,månevandring,østerlænding,hedebosyning,duplikering,affugtning,estimering,velcrolukning,formatering,fraspaltning,filetering,indkrævning,naturalisering,forkludring,centrering,omberegning,destruering,overskrivning,perfektionering,illuminering,svidning,deklarering,kurvefletning,anknytning,stopfodring,symbolisering,kobberstiksamling,tidsstyring,inddampning,særforplejning,knaplukning,postanvisning,chartring,udsættelsesforretning,materialehåndtering,begitning,knæløftning,oplagsnæring,pulverisering,stopning,tendenslodtrækning,opbringning,rateforsikring,abdicering,triangulering,tekstfortolkning,spidsformulering,bejdsning,selektering,meritering,underspilning,intonering,tidsindstilling,tjenestebefaling,føntørring,indfletning,andenhåndsberetning,efterabning,avling,sektionering,fingersætning,grønlandisering,titulering,knoglebygning,afmønstring,sensibilisering,indsnøring,vulkanisering,plissering,fravænning,sammenrodning,bungeejumping,jomsviking,tyveriforsikring,frisering,kodificering,afdramatisering,stagnering,standerstrygning,indrullering,dossering,fritekstsøgning,skruning,udlæsning,hanggliding,varmforzinkning,indøvning,radiospredning,medvirkning,indskibning,motionering,gennemhulning,skiveskydning,snævring,udboring,gennemskæring,dybfrysning,alfastråling,skandering,immunisering,advisering,autoklavering,germanisering,afrivning,udhugning,trepanering,opdrætning,gruppeforsikring,kastning,hvidtning,opsending,trykimprægnering,gardinring,erotisering,transmittering,auditering,guldgravning,lånoptagning,radarovervågning,formuldning,betingning,teknokratisering,snitning,informering,rykning,løftning,udkrængning,immobilisering,analysering,gennemtrumfning,udstikning,nedspilning,overtoning,underopdeling,monitering,tørsvømning,ålænding,myndling,aflægning,gennemboring,topartsforhandling,konditræning,eksilering,grundskoling,afnationalisering,forgæring,kalkulering,udforing,alliancering,skarpskydning,ombooking,tranchering,afstumpning,genmanipulering,opmarchering,spartling,recirkulering,opklæbning,fritering,indhandling,opslugning,lynstegning,transponering,inaktivering,klapning,tilbagerykning,rekonstruering,kagstrygning,verbalisering,overstimulering,harskning,vakuumpakning,udbuling,kompensering,sprogføring,animering,sladderkælling,rekvirering,matrikulering,grusning,gennemstegning,træskæring,printning,tillukning,indmuring,tiljubling,aktivisering,udfoldning,aftabuisering,bodytoning,indkassering,indbrudssikring,dirigering,skyggelægning,åndemaning,botanisering,oversprøjtning,spidning,aflæring,eftersporing,subjektivering,ludbehandling,stratificering,sværtning,luftkonditionering,diktering,udkastning,præferencestilling,genskabning,autorisering,periodelæsning,rådføring,kraftoverføring,madning,besvangring,bomning,topnotering,majorisering,udspecificering,dokumentering,vellystning,glasforsikring,kontrahering,seriefremstilling,indridsning,foliering,håndværkerlærling,hypning,våning,udmanøvrering,ilandsætning,konceptualisering,relativsætning,nedramning,solidarisering,karburering,bukning,stagediving,tredjegradsligning,salutering,fornikling,gennemsivning,udmatrikulering,formynderregering,underforsyning,lytterforening,frilæsning,jordledning,skrubning,apportering,minestrygning,transskribering,pletrensning,termografering,opløftning,indkodning,ompolstring,skafning,valorisering,aftagning,personskadeerstatning,gentegning,taxiflyvning,fertilisering,afideologisering,gennemluftning,indmunding,sandmusling,værling,afsikring,udbyttedeling,eksplicitering,kuvertering,inddrivning,stækning,affedtning,familievejledning,barrikadering,tilridning,studering,smocksyning,overfyldning,eftervisning,optrykning,tyrannisering,headning,optrækning,selvbefrugtning,skarring,kolportering,kokkerering,rombudding,optørring,racediskriminering,gelering,forsåling,indflagning,drypvanding,planering,forvarsling,deflorering,påmønstring,overfrankering,dobbeltholdning,overstrygning,miksning,ilægning,oppiskning,blæsning,underfrankering,gæsteparkering,neddypning,administrering,autolakering,profanering,harvning,smukkesering,falsificering,påligning,underinddeling,ådring,bladring,drøvtygning,flænsning,pilning,sysselsætning,afskrælning,kloring,brystscreening,opridsning,rentesregning,stiføring,udbombning,oliering,misinformering,crowdsurfing,muskelsprængning,konditionering,opskruning,godskrivning,romanisering,rotting,maskulinisering,eutrofiering,indstregning,døgling,snetykning,udrangering,omdigtning,gummiering,punktopstilling,takning,forrykning,drypning,indskydning,fylding,nedstemning,naboovervågning,fralægning,forkulning,vipning,afsnøring,uhyggestemning,mæskning,akkordering,ompotning,fejlcasting,skoning,debitering,oversavning,alkoholisering,indstøbning,sideordning,gennempløjning,indarbejdning,kontrastering,opfiskning,sekvensering,betastråling,forhyring,forpakning,detektering,gasfyring,afsvovling,grutning,bandagering,merbeskatning,renholdning,forstøvning,udhævning,sigtning,snøring,tilføring,affarvning,natostilling,bunkring,korridorforhandling,depravering,skumning,afliring,afkastning,ionisering,oplivning,forpupning,maltning,modforestilling,kontrolopringning,indskrumpning,udlovning,gravsætning,polymerisering,prækvalificering,stepning,guillotinering,koagulering,ekstrapolering,underforsikring,fejlskrivning,splintring,skiftebehandling,komplettering,overhældning,sprøjtemaling,løsøreforsikring,udtværing,tillæring,udsmeltning,korsettering,besejring,forvarmning,binomialfordeling,opskoling,parfumering,ophjælpning,indkobling,illustrering,finindstilling,entring,fortykning,kitning,konturtegning,lasering,divisionalisering,grundering,observering,dematerialisering,mikroskopering,fratrækning,bodypainting,fremdatering,hemmeligstempling,afspisning,sammentømring,kystfodring,farsering,indgnidning,totalsanering,avertering,mørning,oprunding,titrering,kolorering,kalvekastning,afbrækning,afspaltning,glaspustning,hjemmebrygning,computerisering,eskortering,forsætning,notarialforretning,historisering,hulrumsisolering,uddifferentiering,udbasunering,gruppesammensætning,indfyring,partsforklaring,udhungring,omadressering,flydning,særskrivning,stileskrivning,deltagerstyring,afkogning,gurgling,inddragning,tunnelering,minimumnormering,udkonkurrering,indprentning,ridsning,afblænding,nedfotografering,musealisering,teknificering,frosting,frasætning,bundfældning,blodsænkning,ionbytning,fjernkending,synkning,opgejling,sagsøgning,undergæring,indelukning,drikkeskilling,jubelolding,negering,beordring,blindflyvning,indebrænding,udstyring,indikering,herreklipning,travestering,sprogrensning,befugtning,indpiskning,plumbudding,berapning,mørkelægning,lysestøbning,tilhugning,smuldring,opvejning,insolvenserklæring,omlejring,målforskning,afrikanisering,sautering,gradering,smerling,shortpassing,slæbning,indpodning,sammenstikning,infinitesimalregning,stambesætning,udsortering,indrangering,nedstamning,licensering,tilisning,afbinding,petring,trepunktsvending,pixelering,fastgøring,fristilling,perlemusling,indhøstning,tiltning,skrabning,ombukning,lamentering,opreklamering,bortrationalisering,anodisering,bortkastning,filosofering,førstegradsforbrænding,bombardering,ensilering,dampkogning,forudberegning,kølsprængning,prikling,smeltesikring,brodering,typificering,reflektering,materialevandring,frekventering,ruinering,indenadslæsning,udslyngning,primitivisering,svovling,kreering,gilding,glamourisering,prospektering,affedning,omsadling,detonering,afskalling,fabrikering,løbning,gravlægning,minesøgning,inspicering,skalpering,sedimentering,skelettering,sønderrivning,licitering,musikalisering,overklipning,strømkæntring,påmaling,sammenfoldning,sprøjtelakering,parering,fjordmunding,gramfarvning,udspiling,afmåling,bortledning,muring,denaturering,vibrering,filering,ankring,skridning,oppolering,visering,firing,spolering,adoptering,epoxymaling,omkredsning,deeskalering,foresyngning,generindring,parodiering,afsvidning,pausekommatering,udartning,overgæring,filing,dørfylding,dypning,pudring,statuering,folkemindeforskning,danisering,opsvulmning,giftering,poetisering,gætning,udlosning,boremusling,afbarkning,undertegning,maskinstrikning,udbrænding,besværing,samlokalisering,opankring,viderebefordring,fraskrivning,topbelastning,tørstegning,løsrivning,tandoorikylling,lynladning,fuldspartling,varmrøgning,tilgrisning,opstøvning,taljering,nådesbevisning,pulsering,udpresning,tarifering,opflamning,rusmiddelforskning,relatering,følgesætning,tøndehvælving,telegrafering,komponering,frontbetjening,demineralisering,bestrygning,kokkelærling,camouflering,fejltælling,mønning,afstikning,overdimensionering,omprøvning,engagering,stillelæsning,tilfiling,synsforretning,hjemflagning,præservering,fremskydning,inddatering,påtrykning,udpibning,genfinding,udtydning,ækvivalering,fjerding,karikering,udsparing,fejlhuskning,kasusbøjning,begramsning,afrigning,containerisering,afskumning,autoopretning,amalgamering,boning,krækling,væbning,personsøgning,indlemning,stangning,forforstærkning,udtrætning,pilling,affordring,skematisering,grilning,skriftstøbning,nagling,chifrering,styrtning,temperaturtagning,parlamentering,fremturing,tidssætning,stalking,omdøbning,fredlysning,gasrørsledning,foling,nedsaltning,aftrædning,halvdagsstilling,dukkeføring,afdrivning,gennemsyring,lunkning,facettering,girering,relegering,forulempning,virilisering,dryptørring,trafikering,appretering,overklistring,flankering,tilsending,rinkning,gatåbning,præfiksafledning,hensigtssætning,crowdsourcing,afsvækning,prohibitivpåtegning,firepartsregering,tyndslidning,parsing,vidimering,gelatinering,helflugtning,invertering,indemuring,deklamering,HFI-sikring,slidsning,volding,miljøprøvning,udpinding,mineoptagning,udsanering,protokollering,terrassering,trawling,designering,forskubning,blokning,dupering,omfatning,trådning,hønekylling,tilgitring,gagering,udplacering,afkvistning,eftermodning,streaming,radsåning,synkretisering,desktoppublishing,dags dato-kvittering,zapning,tilkastning,forzinkning,afregistrering,skødning,udsvedning,okkupering,buning,editering,radiodirigering,kapsling,ballepresning,søndring,tidsstempling,udsprængning,udrivning,immatrikulering,matchracing,konturering,indladning,allegorisering,eftersending,slækning,koldrøgning,dybkøling,konferering,typisering,palpering,foruddiskontering,minusløsning,paralysering,kuldkastning,pointberegning,frottering,indhugning,teksturering,konfektionering,fordakning,taktering,boarding,tiltuskning,udlåning,faxning,spækning,skvisning,rejicering,dag til dag-levering,antedatering,fremelskning,spørgesætning,gnavning,vognfading,sintring,hofholdning,udgranskning,krybning,trassering,solitærring,ledstilling,stængning,tintning,e-læring,instituering,salpetersyrling,udkragning,ruskning,krepning,trending,mejning,flosning,tidsdeling,optering,udmajning,nedhaling,toldforretning,kortgivning,strømlining,udsavning,bespænding,derivering,klinkbeklædning,syntetisering,diagonallæsning,uddrivning,ovnlakering,underslåning,mortificering,udpolstring,frustrering,kredsning,følgeledsætning,indfasning,ribning,garnisonering,flammesvejsning,patentstrikning,afhærdning,pisning,indgiftning,mugning,fotosætning,gnistspænding,anglisering,fylking,afgivning,klarificering,indstævning,lavtflyvning,undereksponering,aktionering,kølning,versificering,opflaskning,figurering,afhorning,sammentrængning,trædning,afgrøftning,græcisering,kommutering,stakning,afbladning,guidning,aftjekning,plotning,afhjemling,børstebinding,-åring,instruering,gennembagning,rokning,protegering,antikisering,testamentering,ophøjning,berejsning,vinddrejning,indsnusning,hægtning,alternering,substituering,fostring,korrugering,letning,indsukring,stencilering,bogtilrettelægning,kviltning,garrottering,prygling,antegning,tilbinding,glitning,genudvinding,leksikalisering,udmønstring,defilering,fetering,sjofling,fortinning,svinebinding,læskning,svumning,dirkning,bestrøning,egalisering,kærning,hjemskrivning,gårding,tracering,grillering,eksploitering,signalisering,patentudtagning,remittering,underfakturering,remplacering,demolering,afridsning,avancering,verbalbøjning,essing,bestænkning,påankning,opspædning,bælgning,kipning,banderolering,giring,polemisering,spytning,hamring,sukring,afglatning,afpasning,evaporering,svabring,traversering,indklamring,sjakring,indstempling,godtkøbsforklaring,kautionering,serumbehandling,deplacering,fremtrylning,palletering,borteliminering,afhaspning,sammenrystning,indhylling,forhudning,depreciering,mercerisering,besprøjtning,irisering,bronzering,magasinering,emaljering,kobberstikning,antirefleksbehandling,underkøling,harpunering,brunering,addering,varmgalvanisering,indvævning,stansning,udsyring,interpolering,damprensning,skjortelinning,udmejsling,panelering,teltslagning,konvolutering,kronesænkning,udfasning,fremdragning,opvridning,skraffering,udtæring,sammensnerpning,udkåring,elektrosvejsning,typografering,indslibning,klæbning,grendeling,euforisering,prøvefilmning,bænkning,transistorisering,krakning,tvinding,propning,opspiling,afnakning,indføjning,afbremsning,stipulering,plakatering,g-påvirkning,bølgning,nedrunding,istemning,overrækning,skovling,brusning,udstansning,udhamring,underdønning,fedning,radiomodtagning,wakeboarding,klovbeskæring,tryning,kapning,klimatisering,årsagssætning,kalligrafering,formumning,TV-overvågning,interimskvittering,roduddragning,permanentbølgning,indhuling,dementering,forløftning,homologisering,fluktuering,fremkaldning,trangsvurdering,nedmejning,vindicering,forbening,sammenfældning,epilering,diskreditering,indsænkning,grundværdistigning,spatiering,interpellering,misrekommandering,underhandling,kapunering,steptræning,raspning,afløvning,totrinsløsning,stenografering,elskling,udbankning,kryptografering,stænkning,konfundering,MR-scanning,fortænding,tastning,materialeprøvning,pantning,hærgning,kalfatring,opsmøgning,stødning,grusspredning,ekspatriering,tjenestegøring,purering,vævling,flængning,aftakling,autogensvejsning,indplantning,skumlæsning,driftssikring,hængsling,bardering,flerpartsforhandling,forpestning,overskylning,forhåndsreservering,abandonnering,tilpropning,referering,transferering,kannelering,eftertænding,tohåndsbetjening,deviering,inventering,forindstilling,prolongering,tilraning,afpæling,gipsning,regionalplanlægning,deodorisering,ilandbringning,tillavning,opstandsning,kanonering,e-learning,kalkunkylling,filmning,sammentrædning,oversidning,lækning,skæftning,pløkning,døgnåbning,tragtning,sammenrykning,kommittering,forkætring,kenning,opsnapning,litografering,perspektivplanlægning,afsminkning,opdigtning,gildning,klunsning,opslæmning,fragtning,postdatering,abonnering,trængning,agglutinering,sinkning,gennemvævning,skalmuring,synkopering,triumfering,meritoverføring,dominering,saftning,tilforordning,tabellering,rining,shirting,underbefolkning,tjæring,gravitering,detachering,okulering,vaffelvævning,drysning,molestering,klandring,datastyring,udmatning,lænkning,finering,tromling,selvplukning,kløftning,tampning,haspning,subtrahering,kombinering,interimsregering,falsning,trindeling,vandsamling,paragrafering,kobberforhudning,galopering,krølning,turtagning,SMS-afstemning,bladning,budgivning,pubesbehåring,approbering,nuludledning,rendegravning,nedføring,stubfræsning,hårrørsvirkning,mejsling,hakkekylling,tidsledsætning,interviewning,zoomning,dogmatisering,foregøgling,emulering,prognosticering,udsøgning,segmentopdeling,downloading,stileretning,skråstilling,rebslagning,møgspredning,absentering,uddykning,grimassering,konsonantfordobling,formskæring,overskygning,underbinding,endossering,udbinding,CT-scanning,afvarsling,indsyngning,tamponering,omslutning,forskruning,overhedning,udtolkning,decentrering,patning,sammenstimling,opstrengning,trokling,stiftning,mouillering,cirkulering,målsøgning,geminering,aggregering,transplantering,splidsning,påhøring,odsing,høbjergning,højisolering,børneklipning,gælning,udrømning,duellering,konfrontering,gyngning,participering,anløbning,demonstrering,brækning,afpropning,kollationering,renskæring,bulkladning,udsaltning,overspringning,indbytning,denationalisering,udspejdning,kuppelhvælving,panamavævning,skætning,speakning,bajonetfatning,klarering,dammusling,indfældning,klavring,overlydsflyvning,valsning,afparering,udstaffering,indsæbning,brakning,indankning,afhøstning,afinstallering,oplistning,svævning,styning,emulgering,in vitro-befrugtning,onlinebehandling,eftergøring,palning,fedronning,dragering,stregning,trænering,grønthøstning,chaptalisering,henføring,inokulering,skelsætning,afvalmning,fugtning,nasalering,initialisering,opfangning,efterdatering,hegling,udarmning,omslyngning,afrimning,bootning,hæftning,friskning,årsagsledsætning,færgning,rifling,pilkning,monoftongering,fønbølgning,desarmering,enåring,tovning,ordføjning,platinering,afmejning,sidsteøjebliksløsning,kæmning,stampning,kobbertrykning,gitring,udrøring,slingring,kradsning,kønsbøjning,vattering,sankning,passering,gafning,longering,diftongering,leddeling,gysning,indesnening,bundtning,rundstrikning,litrering,trykkerlærling,lempning,metallisering,afspritning,skalkning,grydestegning,hensætning,analogisering,hvæsning,fuldtekstsøgning,rekapitulering,overøsning,O-ring,grundstofforvandling,understimulering,sammenrulning,dollering,glatning,forfranskning,overgearing,multitasking,indhæftning,karbonisering,skuring,satirisering,palatalisering,fribadning,kransning,kælkning,paradering,tilkøring,skønskrivning,rektificering,bonitering,eksponentialligning,tønderknipling,excerpering,aggravering,latinisering,eskamotering,drosling,dobbeltskrivning,nitning,ovntørring,randing,indregulering,tapsamling,snefejning,obducering,drøvling,TV-sening,televisering,aktering,konstruering,vandtrædning,hensigtsledsætning,dissentiering,hysning,tagunderstrygning,kridtning,spunsning,hypnotisering,sekundering,distrahering,podsolering,dimittering,styrtdykning,ondulering,forholdsregning,tangforløsning,plumring,fornorskning,tilsjofling,isprængning,biografering,demarkering,indstikning,subsumering,vedtegning,uddragning,kvadrering,byggeomkostning,prikning,bivuakering,opelskning,forsvenskning,udmarvning,afprivatisering,udkerning,prajning,surfriding,falmning,islægning,doksætning,hugning,afreagering,suffigering,strigling,lænsning,transitering,henledning,oversmøring,permanentkrølning,grøftning,linjering,forkvakling,individualundervisning,udblokning,lobhudling,hospitering,refusering,kantonnering,trunkering,teleskopaffjedring,idriftsætning,drilning,forstemning,familiarisering,afsæbning,notning,opslidning,summering,vugning,afgrening,datamatisering,tufting,tilskødning,coaching,dybdemåling,tværretning,uploading,rystning,ifyldning,supervisering,gennemløbning,vegetering,afblankning,desorganisering,udmagring,elementærundervisning,forslumning,fremprovokering,punsling,sammenslyngning,saldering,klaverforretning,disengagering,røding,ct-scanning,inkriminering,flådning,vikariering,lægtning,afskridtning,parafering,underdimensionering,udgroning,kandisering,haglskadeforsikring,ombøjning,buskning,plastificering,typetegning,svajning,uv-stråling,granulering,cheerleading,paraffinering,gennemrodning,jodbehandling,fluidisering,tuschering,afbagning,udæskning,gradmåling,strøbemærkning,aromatisering,listedækning,udvejning,indprægning,kujonering,udbæring,toupering,kalvning,skodning,paginering,hjemme-PC-ordning,udstening,klining,åreforfedtning,formtørring,klorering,redressering,låring,nejning,bortvandring,rødning,ribstrikning,duvning,atrofiering,kumulering,skanseklædning,harcelering,dressering,liering,barbarisering,snekastning,processkrivning,katekisering,dagbrækning,klemning,afmagnetisering,dispergering,abstrahering,dobbeltbrydning,østlænding,attachering,fundamentering,indkopiering,malning,varpning,mergling,attakering,basering,plettering,U-vending,knapning,kontrasignering,røgtning,mejetærskning,slæmning,tagging,kompostgødning,fosforescering,mattering,public relation-afdeling,labialisering,formøbling,hypostasering,indklipning,indklarering,affladning,logning,skærpning,pælemusling,færdiggøring,tvætning,fleksning,udarbejdning,pelletering,bortadoptering,desinformering,overkogning,maskinisering,kartering,klinkning,oversomring,antistatbehandling,rapning,annotering,subventionering,startomkostning,indhakning,arkaisering,stribning,førstegradsligning,NPK-gødning,tale-høre-undervisning,sufflering,panamabinding,fortoning,opsprætning,CO₂-udledning,temalæsning,spidsning,resumering,evolering,indfiltring,substantivering,knæsætning,depersonalisering,afæskning,transportering,dokning,brankning,lixning,autonomisering,looping,afgnavning,rejfning,adsorbering,vantrivning,knopning,splitning,sengevædning,oldtidslevning,tøjring,pustning,matchfixing,olie-eddike-dressing,udludning,anduvning,neddrosling,mr-scanning,teltning,transpirering,udstempling,gennemkomponering,fremmaning,omarbejdning,hyssing,vindaflejring,vokalisering,rumstering,V-udskæring,lægtring,funktionalisering,spørgeledsætning,paspolering,opkvikning,stolpelukning,afgnidning,HR-afdeling,tofagsordning,snorkning,rørfletning,nedslagning,sødning,ægstilling,rentrykning,rynkning,ekstemporering,indterpning,normannerhøvding,råsyltning,affødning,pomadisering,indicering,afbrydning,touchering,forgrovning,reificering,sining,afhudning,topforhandling,deklinering,overstempling,grooming,matchning,prekarisering,sivning,fordunkling,overkogssikring,ramponering,læmning,emigrering,udfritning,forpurring,bording,thousand island-dressing,fasning,indfortolkning,sønderlemning,svovlsyrling,kommissionsforretning,lædering,shamponering,strengning,overforsikring,dolkning,efterbrænding,landskampsstemning,tilhylning,afpersonalisering,løsgøring,p-ring,enkeltskrivning,fremlejning,traktering,krabning,afplukning,betrækning,lystring,grønsaltning,skøjtning,dekupering,flødning,klapsning,stagning,konformering,toskilling,lokning,udføring,sopning,flammeskæring,opgivning,kuldeblanding,beredning,ekspedering,snorkling,reolpløjning,tabulering,de facto-flygtning,omramning,sadling,improvisering,udparcellering,dupning,kompilering,kvældning,ankerkætting,persning,røring,reversering,hydrering,omrystning,passivering,kurssætning,dameklipning,udklasning,applicering,viskning,overdængning,kachering,sprinkling,opvigling,svejfning,afrømning,stivning,social- og sundhedsforvaltning,aftrykning,tro og love-erklæring,gennemprygling,damascering,vitaminisering,krokering,bestialisering,bortoperering,gimpning,gangning,spoling,tarering,omhylling,underdrejning,blindlanding,købslagning,gaussfordeling,spinning,tilmåling,pelsning,klarning,kardiotræning,eftermørkning,boykotning,overpolstring,phishing,tilordning,hudstrygning,indbagning,attestering,isyning,laskning,potning,plejning,dropning,duplicering,indslumring,postindkassering,permittering,forskrivning,sejtrækning,afkrævning,halvflugtning,ensartning,nikotinforgiftning,fingerering,keling,valkning,skateboarding,medtagning,rikochettering,emancipering,krydshvælving,trefagsordning,rebning,forkrøpning,konfirmering,skulkning,pokulering,indkalkulering,kloroformering,intubering,høvling,schedulering,konvojering,selvaflæsning,schæchtning,udkæmpning	ting,folketing,ring,spring,sving,opsving,forspring,udsving,udspring,sting,swing,sidespring,landsting,selvsving,krumspring,alting,messing,kvantespring,lagting,tigerspring,længdespring,højdespring,højresving,storting,venstresving,hårnålesving,stangspring,faldskærmsudspring,håndsving,trespring,fremspring,korssting,elastikspring,kraftspring,omsving,hovedspring,armsving,opspring,badutspring,herresving,løvspring,trampolinspring,vejsving,forsting,nedsving,stikkesting,værneting,kædesting,dødsspring,lasting,knaphulssting,herredsting,nedspring,risting,sidesting,heksesting,sømmesting,blindsting,shirting,hulsting,trafficking,flyvespring
3	lse	1377	0.00548	1353	24	forbindelse,undersøgelse,uddannelse,ledelse,bestyrelse,oplevelse,begyndelse,følelse,indflydelse,størrelse,opfattelse,bevægelse,afgørelse,forståelse,udtalelse,besparelse,tilværelse,fornemmelse,anmeldelse,henvendelse,betingelse,deltagelse,ydelse,overraskelse,omgivelse,forbrydelse,optagelse,tilladelse,beskæftigelse,undtagelse,udvidelse,begrundelse,overvejelse,udsendelse,beskrivelse,udgivelse,opgørelse,pressemeddelelse,anvendelse,beskyttelse,lidelse,fornøjelse,ansættelse,skikkelse,anelse,meddelelse,redegørelse,forpligtelse,øvelse,anerkendelse,skattelettelse,betegnelse,erkendelse,forberedelse,oversættelse,besættelse,forlængelse,bekæmpelse,fagbevægelse,bestræbelse,skuffelse,bestemmelse,styrelse,overensstemmelse,opførelse,kommunalbestyrelse,besiddelse,tilstedeværelse,godkendelse,hændelse,forsinkelse,dannelse,overtrædelse,anholdelse,misforståelse,fornyelse,opdagelse,indførelse,oprettelse,begravelse,lettelse,overlevelse,hukommelse,overtagelse,offentliggørelse,vedligeholdelse,sigtelse,oprindelse,efteruddannelse,opholdstilladelse,pølse,iscenesættelse,drøftelse,udbredelse,forebyggelse,udnyttelse,gentagelse,kendelse,ødelæggelse,opfindelse,vedtagelse,udnævnelse,modtagelse,undertrykkelse,anstrengelse,oversvømmelse,indrømmelse,krænkelse,bebyggelse,bedømmelse,fejltagelse,opdragelse,splittelse,afskaffelse,befrielse,afskedigelse,opfyldelse,fortsættelse,forargelse,styrkelse,gennemførelse,bekendtgørelse,indvielse,fristelse,indsigelse,henrettelse,beføjelse,udfoldelse,nedsættelse,erhvervsuddannelse,forringelse,nydelse,bestikkelse,bosættelse,indlæggelse,antagelse,læreruddannelse,forfølgelse,skabelse,velsignelse,arbejderbevægelse,forhøjelse,modstandsbevægelse,berømmelse,forelskelse,forudsigelse,selvforståelse,ydmygelse,skolebestyrelse,tilføjelse,adskillelse,lempelse,udførelse,opsigelse,iagttagelse,ophævelse,nyskabelse,nedlæggelse,frelse,fordømmelse,forkortelse,uoverensstemmelse,tilkendegivelse,fordybelse,misundelse,udarbejdelse,krigsforbrydelse,kvæstelse,gengivelse,løsladelse,stiftelse,udsættelse,berettigelse,besvarelse,forøgelse,bekræftelse,politianmeldelse,fjernelse,tilgivelse,forbandelse,påmindelse,medfølelse,bevarelse,forsørgelse,udvælgelse,bekendelse,fortvivlelse,opstandelse,tilblivelse,forseelse,svækkelse,frigørelse,forstyrrelse,vielse,frifindelse,serviceydelse,indsættelse,rettelse,beklagelse,ærgrelse,bortførelse,armbevægelse,forlystelse,godtgørelse,inddragelse,overskridelse,selvangivelse,prøvelse,overdragelse,anbringelse,indlevelse,tilnærmelse,indtagelse,understøttelse,beboelse,tilståelse,overdrivelse,lovovertrædelse,skrivelse,afbrydelse,rystelse,folkebevægelse,dyrkelse,fornærmelse,afvigelse,tjenesteydelse,lønforhøjelse,krigsførelse,selvbestemmelse,tilfredsstillelse,byfornyelse,anseelse,videreuddannelse,byggetilladelse,magtovertagelse,mindelse,spiseforstyrrelse,udryddelse,hørelse,udelukkelse,angivelse,begavelse,videooptagelse,selvransagelse,hjemsendelse,frigivelse,forsendelse,hensættelse,løsrivelse,fremlæggelse,udskejelse,tilrettelæggelse,universitetsuddannelse,bisættelse,skærpelse,overholdelse,istandsættelse,sammensværgelse,helbredelse,indgåelse,nyhedsudsendelse,tilskyndelse,retsforfølgelse,lungebetændelse,skyldfølelse,tiltrædelse,fastholdelse,udtagelse,arbejdsnedlæggelse,fortrydelse,udmærkelse,forkyndelse,afstraffelse,tykkelse,betændelse,optegnelse,forbløffelse,genudsendelse,afholdelse,udmeldelse,forretningsforbindelse,forundersøgelse,frihedsberøvelse,forskrækkelse,udstedelse,lammelse,omdannelse,oprørsbevægelse,indkaldelse,forkølelse,bemyndigelse,opretholdelse,selvopfattelse,hjernerystelse,eksistensberettigelse,anskaffelse,genoptagelse,færdiggørelse,udskydelse,overrækkelse,ængstelse,grunduddannelse,kvindebevægelse,medbestemmelse,brandstiftelse,jordforbindelse,forsømmelse,børneopdragelse,grundlæggelse,berigelse,opsendelse,bogudgivelse,indbydelse,videreførelse,uropførelse,anskuelse,domsafsigelse,skatteforhøjelse,fortielse,tvangsfjernelse,frakendelse,selvfølelse,genkendelse,bedøvelse,modydelse,blodsudgydelse,modsigelse,forlovelse,udslettelse,forældrebestyrelse,mistænkeliggørelse,bevisførelse,internetforbindelse,fratrædelse,mavefornemmelse,vildfarelse,nedbringelse,underskrivelse,bearbejdelse,omfavnelse,kerneydelse,forfremmelse,anlæggelse,dommerkendelse,vækkelse,ildspåsættelse,erhvervelse,livsførelse,ophidselse,domfældelse,akutmodtagelse,forskønnelse,skoleledelse,stavelse,udøvelse,tilbageholdelse,fastsættelse,fredsbevægelse,medindflydelse,varetagelse,udmattelse,trosbekendelse,forførelse,lignelse,frembringelse,udskrivelse,helse,genindførelse,besværgelse,beslaglæggelse,selverkendelse,latterliggørelse,diplomuddannelse,overgivelse,underdrivelse,væmmelse,prøveløsladelse,benægtelse,hævelse,besindelse,solformørkelse,indskydelse,selvmodsigelse,fremmedgørelse,afgivelse,selviscenesættelse,underkastelse,overværelse,håndhævelse,fritagelse,genanvendelse,gengældelse,benyttelse,nationalfølelse,forkælelse,spegepølse,foreteelse,genudgivelse,inddrivelse,anfægtelse,retsfølelse,radioudsendelse,misdannelse,beherskelse,forbavselse,miljøbeskyttelse,boligydelse,forstoppelse,andelsbevægelse,påskønnelse,irettesættelse,opinionsundersøgelse,fortabelse,retskendelse,kødannelse,korsfæstelse,opgivelse,indfrielse,lemlæstelse,ankestyrelse,fordrivelse,tilsidesættelse,udstødelse,efterfølgelse,forglemmelse,omvendelse,genopstandelse,adspredelse,fornedrelse,bestyrtelse,sindslidelse,fornægtelse,nyerhvervelse,indlemmelse,sendetilladelse,kraftanstrengelse,afbenyttelse,hospitalsindlæggelse,fordøjelse,lægeundersøgelse,forfærdelse,tilegnelse,magtbeføjelse,båndoptagelse,virkeliggørelse,bebrejdelse,bagvaskelse,mentalundersøgelse,rullepølse,betagelse,naturbeskyttelse,fællesbetegnelse,tilfangetagelse,fortegnelse,iværksættelse,benovelse,tilbedelse,tildragelse,beruselse,helårsbeboelse,boldbesiddelse,indmeldelse,agtelse,stivelse,hengivelse,nævnelse,helbredsundersøgelse,brugerundersøgelse,forrådnelse,røgelse,telefonforbindelse,fastlæggelse,livsanskuelse,ledsagelse,situationsfornemmelse,forældelse,præmieoverrækkelse,besigtigelse,tilintetgørelse,renselse,grillpølse,udskillelse,udeblivelse,strømafbrydelse,opnåelse,forråelse,fremførelse,spareøvelse,tilsnigelse,voksenuddannelse,overvindelse,udgydelse,genskabelse,kvababbelse,lovliggørelse,forhånelse,formørkelse,genopførelse,leverbetændelse,lykkefølelse,totaloplevelse,nyoversættelse,fratagelse,bibeskæftigelse,undfangelse,fastansættelse,medisterpølse,ligeberettigelse,halsbetændelse,hemmeligholdelse,fortryllelse,omgåelse,ansvarsforflygtigelse,hæftelse,bortskaffelse,misligholdelse,taksigelse,frikendelse,benævnelse,basisuddannelse,fremhævelse,forbitrelse,træbeskyttelse,afskrækkelse,forstillelse,nedkæmpelse,fremsættelse,billigelse,varebetegnelse,færgeforbindelse,afsendelse,udeladelse,fortalelse,genoprettelse,forladelse,syndsforladelse,fremkaldelse,personlighedsforstyrrelse,kildebeskyttelse,overtalelse,afsættelse,igangsættelse,verdensopfattelse,forarmelse,forflyttelse,beroligelse,rejsebeskrivelse,forhåndsgodkendelse,efterlevelse,umyndiggørelse,pågribelse,afståelse,stadfæstelse,mytedannelse,beskuelse,endelse,nyanskaffelse,pligtforsømmelse,begunstigelse,selvbeherskelse,blottelse,retfærdiggørelse,overstørrelse,ghettodannelse,arbejdsmarkedsuddannelse,forelæggelse,hadforbrydelse,forkastelse,valse,indholdsfortegnelse,sikkerhedsstillelse,fuldbyrdelse,interviewundersøgelse,fordyrelse,overanstrengelse,pligtfølelse,indskærpelse,genopdagelse,smørelse,førsteopførelse,eftergivelse,imødekommelse,blindtarmsbetændelse,beskikkelse,henrykkelse,fingerspidsfornemmelse,underkendelse,almendannelse,husførelse,forstørrelse,tilbagekaldelse,korttidshukommelse,indsendelse,forherligelse,faderskikkelse,strafskærpelse,undladelse,opofrelse,misbilligelse,bevidstgørelse,uddrivelse,aflæggelse,betroelse,tvangsindlæggelse,legemsbeskadigelse,renholdelse,indrejsetilladelse,drikkelse,strækøvelse,selvhævdelse,nydannelse,blærebetændelse,bagtalelse,tilbagesendelse,rørelse,foryngelse,udfrielse,påbegyndelse,retshåndhævelse,blodpølse,måneformørkelse,henlæggelse,genopdragelse,kristenforfølgelse,gudsdyrkelse,berigtigelse,opbyggelse,afhændelse,udfærdigelse,påberåbelse,synsforstyrrelse,festligholdelse,finfølelse,fødselsforberedelse,ærekrænkelse,ikrafttrædelse,beskadigelse,højnelse,undsigelse,fremskaffelse,gældseftergivelse,selvbebrejdelse,lokalbedøvelse,meningstilkendegivelse,forsyndelse,imødegåelse,forudanelse,gruppeledelse,fordummelse,skatteansættelse,nærdødsoplevelse,tilvejebringelse,raceadskillelse,fuldtidsbeskæftigelse,knægtelse,ophøjelse,gendannelse,kikkertundersøgelse,legemliggørelse,samlebetegnelse,forurettelse,liveoptagelse,selvudfoldelse,overførelse,fortørnelse,nedværdigelse,udpegelse,husundersøgelse,sindsbevægelse,sædelighedsforbrydelse,gallupundersøgelse,åremålsansættelse,tilskikkelse,nedgørelse,besyngelse,forfladigelse,bebudelse,forklarelse,fjernsynsudsendelse,skyggetilværelse,selvopofrelse,besvimelse,tilkendelse,idoldyrkelse,nærværelse,skattebegunstigelse,omskiftelse,resultatopgørelse,udrejsetilladelse,kontrolundersøgelse,hjernebetændelse,masseudryddelse,misfornøjelse,stemmeafgivelse,strøelse,levendegørelse,forfinelse,kransenedlæggelse,genansættelse,etageadskillelse,undvigelse,bedrøvelse,iværksætterydelse,tidsbesparelse,hævdelse,tidsangivelse,værdsættelse,kørselsgodtgørelse,udgangstilladelse,selvagtelse,håndspålæggelse,udfyldelse,overbygningsuddannelse,fuldendelse,djævleuddrivelse,nægtelse,formindskelse,selvforherligelse,påkaldelse,statsbegravelse,pinsebevægelse,persondyrkelse,langtidshukommelse,omskærelse,undergrundsbevægelse,tydeliggørelse,indtrædelse,fravigelse,åndsnærværelse,filmanmeldelse,laboratorieundersøgelse,beredskabsstyrelse,brugeroplevelse,tidsopfattelse,forulempelse,udtrædelse,genoplivelse,genindsættelse,fejlbedømmelse,dygtiggørelse,sexforbrydelse,mæthedsfornemmelse,unddragelse,driftsforstyrrelse,kødpølse,forsagelse,edsaflæggelse,erhvervsgrunduddannelse,hjemkaldelse,vandbakkelse,førelse,ransagelse,kongerøgelse,tingsliggørelse,idriftsættelse,cocktailpølse,straffastsættelse,aftrædelse,jordrystelse,befippelse,tronbestigelse,forjættelse,revselse,græmmelse,mødeindkaldelse,opbydelse,omstødelse,genovervejelse,forstavelse,afsigelse,øjenbetændelse,optugtelse,sygehusindlæggelse,vildelse,svangerskabsafbrydelse,undertegnelse,indgivelse,typegodkendelse,strafforfølgelse,fremsendelse,hakkelse,foruroligelse,afholdsbevægelse,indstiftelse,forforståelse,ørkendannelse,kraftudfoldelse,tvangsanbringelse,blotlæggelse,selvstændiggørelse,fremskyndelse,nedbrydelse,mindskelse,bihulebetændelse,kunstforståelse,engangsforeteelse,hjemtagelse,bibeholdelse,anråbelse,ansigtsgenkendelse,bispevielse,afsyngelse,behovstilfredsstillelse,retfærdighedsfølelse,skriveøvelse,gudsbespottelse,ordrebekræftelse,bølgebevægelse,fuldførelse,kålpølse,talstørrelse,indskrænkelse,anskueliggørelse,ahaoplevelse,fortykkelse,foregribelse,børnelammelse,cirkulæreskrivelse,indøvelse,fastgørelse,selvantændelse,kaldelse,voldgiftskendelse,udsigelse,forblindelse,søpølse,indhentelse,forretningsførelse,omgørelse,legatbestyrelse,antændelse,forbigåelse,rundskrivelse,kulderystelse,tjenestemandsansættelse,selvundersøgelse,jordpåkastelse,anstiftelse,kornstørrelse,hjernehindebetændelse,højtideligholdelse,ejerfornemmelse,dyrebeskyttelse,fordærvelse,ungdomsydelse,forvildelse,dyppelse,luksustilværelse,leveringsbetingelse,knibeøvelse,misopfattelse,undgåelse,genoplevelse,omstyrtelse,forgudelse,gældsstiftelse,selvbekræftelse,merituddannelse,menneskeliggørelse,tillokkelse,pengeanbringelse,tilberedelse,jordfæstelse,indforståelse,opsættelse,sprogtilegnelse,forrykkelse,bespottelse,kundgørelse,selvfornægtelse,nyttiggørelse,formildelse,bilæggelse,nervebetændelse,moderskikkelse,fejlmeddelelse,verdsliggørelse,gendrivelse,underkuelse,værkfortegnelse,pilotundersøgelse,bodsøvelse,efterprøvelse,ihukommelse,billiggørelse,navlebeskuelse,tilmeldelse,forsmædelse,berøvelse,engangsydelse,afsværgelse,genfødelse,indarbejdelse,mangfoldiggørelse,gravlæggelse,genkaldelse,tilsigelse,svarskrivelse,idømmelse,beskæmmelse,legemsstørrelse,målbeskrivelse,synsnedsættelse,fredeliggørelse,æresfølelse,helliggørelse,skrivebordsafgørelse,anspændelse,lånoptagelse,vederkvægelse,ruelse,befæstelse,udsvævelse,slutopgørelse,genindkaldelse,umenneskeliggørelse,forgabelse,wienerpølse,tilkaldelse,tomhedsfølelse,forsættelse,forhærdelse,fordrejelse,forevigelse,selvovervindelse,uskadeliggørelse,indbringelse,uddybelse,omverdensforståelse,fraværelse,fradømmelse,genopbyggelse,borgerliggørelse,foregivelse,fondsdannelse,opøvelse,orddannelse,omskabelse,friholdelse,affattelse,klorforbindelse,inderliggørelse,forstærkelse,betryggelse,underbeskæftigelse,affærdigelse,indoptagelse,agterskrivelse,besvigelse,begrædelse,oparbejdelse,slækkelse,berammelse,videresendelse,fagfællebedømmelse,følgeskrivelse,artsbestemmelse,hjemsøgelse,samfølelse,blokdannelse,efterstræbelse,feltundersøgelse,løftelse,hjemgivelse,tidsbestemmelse,begribelse,mønsterbeskyttelse,tilbagetrædelse,indeholdelse,opløftelse,stedsangivelse,fremtrædelse,principgodkendelse,syndsbekendelse,behovsudsættelse,klarlæggelse,smidiggørelse,prydelse,præstevielse,undertvingelse,båndlæggelse,allestedsnærværelse,ordforbindelse,forfjamskelse,afkræftelse,trolovelse,sommerforkølelse,ørebetændelse,opvækkelse,højagtelse,regnskabsførelse,selvfordybelse,soldyrkelse,opinionsdannelse,forflygtigelse,indføjelse,utilstrækkelighedsfølelse,spægelse,nedtagelse,anførelse,strafbestemmelse,klargørelse,knækpølse,afslappelse,vidnegodtgørelse,overflødiggørelse,fuldkommengørelse,genanskaffelse,prisgivelse,udbydelse,overvældelse,foretagelse,tilbageførelse,bortfjernelse,ædelse,oversendelse,tugtelse,navngivelse,besmittelse,stedfæstelse,fruestørrelse,lovfæstelse,salvelse,omarbejdelse,beklikkelse,kropsbeherskelse,forhekselse,taktfølelse,underforståelse,forlokkelse,forudbestemmelse,korrosionsbeskyttelse,afsvækkelse,forskrivelse,husvalelse,pandehulebetændelse,udtømmelse,opdyrkelse,overspringelse,bedyrelse,planlæggelse,vildførelse,forarbejdelse,forløbelse,fremsigelse,forhippelse,fyldestgørelse,ombringelse,hjertekvababbelse,hasteindlæggelse,undseelse,forværrelse,iltforbindelse,hasteindkaldelse,medtagelse,fraskrivelse,bogstavbetegnelse,vederlæggelse,opbringelse,henførelse,bemægtigelse,vildledelse,fingerøvelse,typebestemmelse,bønfaldelse,forstødelse,alenetilværelse,hjembringelse,godtagelse,bestyrkelse,retningsbestemmelse,bestridelse,beståelse,miskendelse,forhåndsmeddelelse,bønhørelse,middelstørrelse,åndsfraværelse,cervelatpølse,bevidnelse,eftersendelse,helligelse,strafforhøjelse,erlæggelse,stedbestemmelse,firmelse,naturalieydelse,frontdannelse,dragelse,satsbetegnelse,beklemmelse,anmasselse,besmykkelse,bøjningsendelse,molekylestørrelse,pantsættelse,tilsendelse,kæbehulebetændelse,initialforkortelse,ikraftsættelse,genindtrædelse,indfangelse,refleksbevægelse,tørrelse,hidkaldelse,tildannelse,forklejnelse,forøvelse,præpositionsforbindelse,fremdragelse,trickoptagelse,roddannelse,gravsættelse,behæftelse,bestigelse,børne- og ungeydelse,lyksaliggørelse,ansvarsfralæggelse,sønderlemmelse,overlistelse,seneskedebetændelse,vestliggørelse,iførelse,vedtegnelse,forsværgelse,rygelse,sprogfølelse,strafeftergivelse,forskånelse,smidighedsøvelse,vanskeliggørelse,veddannelse,ikendelse,undersættelse,opæggelse,tilstillelse,vedlæggelse,undlivelse,de facto-anerkendelse,gældsættelse,klientgørelse,sænkelse,hudflettelse,skadedyrbekæmpelse,erkyndigelse,beskærmelse,oplivelse,forstrækkelse,forbarmelse,indflettelse,kropsliggørelse,findyrkelse,skadeopgørelse,helligholdelse,udståelse,serieforbindelse,åndeliggørelse,fravælgelse,ilandbringelse,bundfældelse,opkaldelse,tilvendelse,guds velsignelse,frilæggelse,aftvingelse,bestormelse,forrettelse,indvælgelse,VPN-forbindelse,vedgåelse,sammenholdelse,risstivelse,cachehukommelse,løsgørelse,åbenbarelse,afværgelse,understregelse,forregnelse,ligbegængelse,pådragelse,forstemmelse,gurudyrkelse,forurenelse,garantistillelse,forstenelse,trykstavelse,besværliggørelse,tilbagedannelse,forblændelse,forkuelse,underordnelse,jævnførelse,pådømmelse,forløftelse,upersonliggørelse,forivrelse,forjagelse,dånelse,bejaelse,indgydelse,forebringelse,udråbelse,overbringelse,mestbegunstigelse,annammelse,indvilgelse,synliggørelse,de jure-anerkendelse,muliggørelse,voldførelse,forskubbelse,sønderknuselse,genydelse,forlæggelse,opfangelse,ud af kroppen-oplevelse,forledelse,gennemtvingelse,kuldkastelse,efterladelse,teknonomuddannelse,rom-størrelse,fæstnelse,tilbagevendelse,afrettelse,overflyttelse,besørgelse,bortkastelse,udkæmpelse,fremrykkelse,eftertragtelse,overilelse,ram-størrelse,blånelse,pro rata-hæftelse,gennemarbejdelse,undergivelse,fremelskelse,hjemførelse,stileøvelse,anrettelse,ibrugtagelse,talelidelse,afførelse,hærdelse,kasusendelse,udredelse,forpestelse,forfægtelse,skadesløsholdelse,besnakkelse,frameldelse,udstyrelse,blødgørelse,forgribelse,fortrædigelse,påkendelse,tilendebringelse,aflokkelse,afvendelse,forgrimmelse,sideordningsforbindelse,vedståelse,træffeøvelse,henlevelse,TV-udsendelse,forgrovelse,sandsynliggørelse,udødeliggørelse,udhævelse,vandrebevægelse,guddommeliggørelse,eftergørelse,viljesanspændelse,løskøbelse,fragåelse,forvanskelse,fuldbringelse,modarbejdelse,undgældelse,kvægelse,formastelse,italesættelse,tilstræbelse,bibringelse,fradragelse,udspredelse,betuttelse,fetichdyrkelse,fremholdelse,afmeldelse,øjenforblindelse,fralæggelse,betrædelse,efterlignelse,ægtevielse,HD-uddannelse,afkortelse,efterabelse,vedføjelse,frembydelse,begrebsliggørelse,antastelse,videnskabeliggørelse,udlæggelse,omprøvelse,sammenkaldelse,deja-vu-oplevelse,tropsøvelse,forsødelse,afmattelse,vanærelse,bekrigelse,fugtdannelse,bivånelse,herliggørelse,tilkæmpelse,påtegnelse,afbeskikkelse,frisættelse,slappelse,forårsagelse,smørepølse,forædelse,underskridelse,gennemdrøftelse,a priori-antagelse,forpustelse,tilgængeliggørelse,forfattelse,VVM-redegørelse,underordningsforbindelse,fuldstændiggørelse,påskyndelse,indladelse,undsættelse,forstuvelse,forkætrelse,ugifteydelse,personliggørelse,umuliggørelse,delagtiggørelse,vædelse,forlibelse,heldagsbeskæftigelse,forsnakkelse,sysselsættelse,antegnelse,interimledelse,frasigelse,rådførelse,betvingelse,ærefornærmelse	værelse,badeværelse,soveværelse,spøgelse,hotelværelse,klasseværelse,børneværelse,dobbeltværelse,venteværelse,lærerværelse,kollegieværelse,gæsteværelse,enkeltværelse,herreværelse,ragelse,pigeværelse,klubværelse,eneværelse,forværelse,kvistværelse,modtagelsesværelse,ungpigeværelse,anretterværelse,toiletværelse
3	ion	895	0.00451	892	3	million,situation,organisation,region,produktion,institution,information,kommission,tradition,generation,diskussion,station,reaktion,pension,nation,religion,operation,opposition,position,ambition,konklusion,version,aktion,division,funktion,inspiration,vision,administration,demonstration,relation,præstation,union,mission,revolution,champion,kommunikation,kombination,redaktion,fusion,integration,sektion,reception,sanktion,kvalifikation,motion,dokumentation,dimension,korruption,obligation,inflation,direktion,frustration,konstruktion,konvention,auktion,daginstitution,depression,instruktion,portion,reduktion,intention,spekulation,eksplosion,koncentration,definition,præsentation,innovation,revision,variation,konfrontation,motivation,ekspedition,invitation,installation,fiktion,kompensation,koalition,invasion,illusion,civilisation,delegation,dispensation,førtidspension,illustration,resolution,argumentation,borgerrepræsentation,introduktion,passion,statsobligation,destination,observation,prostitution,diskrimination,komposition,isolation,politistation,reparation,folkepension,kollektion,fascination,præcision,recession,infektion,attraktion,disposition,provokation,irritation,transaktion,tvangsauktion,distribution,refleksion,repræsentation,sensation,spion,restriktion,action,tankstation,interesseorganisation,donation,proportion,radiostation,kulmination,publikation,ekspansion,indikation,dekoration,licitation,intervention,manipulation,transmission,konsultation,aggression,ammunition,fraktion,desperation,konfirmation,association,lektion,option,hjælpeorganisation,komplikation,rekonstruktion,meditation,konstellation,evolution,bastion,foundation,profession,session,vaccination,emission,adoption,reformation,identifikation,opinion,aircondition,turistattraktion,manifestation,arrestation,acceleration,kollision,inklusion,kapitalpension,formation,møntunion,intuition,korrektion,kaution,indignation,obduktion,børneinstitution,terroraktion,restauration,vibration,kondition,endestation,animation,paraplyorganisation,ventilation,perfektion,migration,stagnation,improvisation,rumstation,inspektion,centraladministration,autorisation,ekspropriation,transformation,prævention,flyvestation,landsorganisation,transplantation,interaktion,billion,togstation,detention,deklaration,mutation,døgninstitution,eksklusion,føderation,refusion,telekommunikation,diskretion,destruktion,edition,applikation,abstraktion,reproduktion,førerposition,brandstation,kulturrevolution,koordination,kreation,immigration,reservation,menstruation,modifikation,navigation,audition,vegetation,visitation,rotation,renovation,inkarnation,genbrugsstation,varedeklaration,provision,location,population,modreaktion,pression,organdonation,konspiration,ekskursion,specifikation,deportation,magtdemonstration,solution,resignation,skorpion,læsion,kapitulation,reinkarnation,forligsinstitution,nødsituation,racediskrimination,cirkulation,inskription,television,separation,masseproduktion,procession,fremtidsvision,afskedsreception,konfiskation,misinformation,aversion,koncession,hallucination,dedikation,overproduktion,inkvisition,selektion,ovation,suspension,slowmotion,servicestation,implikation,projektion,benzinstation,kædereaktion,konversation,blodtransfusion,overreaktion,supervision,grænseregion,egenproduktion,legitimation,progression,ration,maskinstation,jernbanestation,percussion,desillusion,flådestation,veneration,friktion,klassifikation,deflation,diktion,ratifikation,agitation,erosion,kraftpræstation,injektion,amputation,invalidepension,konfektion,assimilation,ordination,legion,rekreation,straffeaktion,promotion,dekonstruktion,jobrotation,distraktion,kation,stimulation,fabrikation,overrepræsentation,coverversion,jurisdiktion,automation,inflammation,returkommission,repetition,lokation,sterilisation,perception,diskvalifikation,udgangsposition,halvpension,vinterdepression,nøgleposition,imitation,perversion,kastration,proklamation,insemination,distinktion,konstitution,toppræstation,pragtpræstation,restitution,fremmedlegion,dissektion,kalkulation,tillægspension,serieproduktion,infiltration,dagrenovation,simulation,vejrstation,yndlingsaversion,obstruktion,kønsdiskrimination,intonation,moddemonstration,eksamination,trillion,likvidation,dysfunktion,korrelation,forsøgsstation,erektion,insinuation,forsvarsposition,aldersdiskrimination,emigration,paneldiskussion,lotion,skolekommission,digression,computeranimation,transition,reklamation,emotion,automatreaktion,genmanipulation,kognition,hyperinflation,figuration,konføderation,transfusion,spedition,alderspension,succession,præmieobligation,jamsession,kooperation,helpension,artikulation,translation,aspiration,deputation,negation,mediation,moderation,degeneration,fejldisposition,kollaboration,fortælletradition,konnotation,konfiguration,dimission,recitation,envejskommunikation,transformatorstation,kompression,bypassoperation,akkvisition,citation,instrumentation,samproduktion,decision,prætention,protektion,hundepension,paladsrevolution,regression,reputation,emancipation,prækvalifikation,influenzavaccination,transskription,transformerstation,illumination,masturbation,ægdonation,penetration,induktion,okkupation,perkussion,detonation,desinfektion,pasunion,bodylotion,enkeltmandspræstation,korrosion,solopræstation,emulsion,bortadoption,allusion,kornproduktion,postekspedition,ungdomspension,datatransmission,modulation,proposition,substitution,fejlinformation,notation,billedlegitimation,straffeekspedition,skyformation,repression,fleksion,svampeinfektion,notifikation,intension,desinformation,magtbastion,infusion,invention,respiration,gestikulation,fluktuation,modtagestation,apparition,pladsreservation,destillation,rekommandation,billedmanipulation,translokation,kontemplation,trodsreaktion,deformation,fiskeriinspektion,addition,fission,adaptation,konkretion,underrepræsentation,personalunion,kontrarevolution,lokalisation,abdikation,ejakulation,kravspecifikation,determination,indiskretion,verifikation,personifikation,implosion,eskalation,koproduktion,kolonisation,præposition,rekvisition,radiumstation,dominion,konfession,oxidation,elimination,faktion,deklamation,manuduktion,anneksion,ekskommunikation,deduktion,mystifikation,akkumulation,regeneration,ægtransplantation,absorption,kassation,konversion,fanfiktion,gravitation,interpretation,akklamation,enkepension,suggestion,recirkulation,hovedreparation,stagflation,perforation,dørspion,affektion,realisation,introspektion,eruption,reintegration,nødration,lavinflation,implantation,excision,segregation,gratulation,kropsvisitation,multiplikation,diffusion,inklination,dagsration,sekretion,eksekution,konfusion,rebellion,absolution,socialisation,ekstraktion,detektion,tension,dagsproduktion,kontraktion,eksposition,subskription,korporation,oscillation,vivisektion,appropriation,betaversion,tovejskommunikation,pollution,centralstation,dissociation,konjunktion,metafiktion,inhalation,individuation,intubation,modaktion,kompilation,børsspekulation,modrevolution,tvangssituation,xenotransplantation,permission,participation,årmillion,obstipation,legation,konsumption,attestation,immunreaktion,præfabrikation,kontraindikation,depravation,diversifikation,egenpension,massesuggestion,elevation,konvektion,deceleration,subtraktion,karantænestation,divination,nomination,lodsstation,naturalisation,selvsuggestion,satisfaktion,petition,desintegration,koagulation,muskelinfiltration,permutation,deprivation,relæstation,transposition,samvariation,alteration,kopulation,krystallisation,konjugation,brodernation,demotivation,polarisation,reorganisation,fragmentation,immatrikulation,dilatation,ekstension,falsifikation,industrispion,fanfiction,genmodifikation,kontamination,subvention,selvpension,inversion,transpiration,differentiation,ekstrapolation,konception,nonfirmation,dekompression,tyrestation,allitteration,obstruction,krydsreaktion,rehabilitation,luksation,præparation,jordspekulation,kapitalakkumulation,koppevaccination,recension,defækation,kremation,bagprojektion,novation,affektation,retention,anticipation,reeksamination,mortifikation,assertion,håndlotion,krydsrevision,annullation,antikonception,lamentation,fertilisation,kommunion,initiation,deviation,kvindeemancipation,indoperation,massefabrikation,eksploration,approksimation,alimentation,radiation,aberration,forhåndsreservation,stratifikation,inhibition,brintion,translitteration,prædiktion,emanation,duplikation,konvulsion,kohæsion,grundspekulation,materialisation,eksemplifikation,proskription,transsubstantiation,eksaltation,interjektion,vokalisation,triangulation,neutralisation,sedimentation,revaccination,kodifikation,rekapitulation,ekstinktion,kongregation,inokulation,deklination,eksponentialfunktion,galion,standbyfunktion,glaciation,anion,calmettevaccination,adsorption,strangulation,prædestination,pulsation,bortoperation,refraktion,folkerepræsentation,dispersion,kondensation,adhæsion,lotterikollektion,kollokation,katekisation,fortifikation,subordination,annotation,fibrillation,diffraktion,amortisation,komparation,sublimation,alienation,torsion,introversion,underproduktion,defloration,kvadrillion,desertion,retransmission,trepanation,konsternation,polymerisation,fermentation,allokation,affirmation,subsumption,approbation,resorption,designation,attribution,demarkation,gratifikation,insubordination,ekstroversion,idéassociation,vind-vind-situation,retorsion,retrofleksion,ionisation,usurpation,agglutination,inkassation,afreaktion,afinstallation,kondemnation,præsupposition,accentuation,specialprævention,repartition,broderorganisation,decentralisation,bidragsresolution,denotation,kanalisation,perseveration,selvisolation,klippe-klistre-funktion,postposition,frekvensmodulation,demission,taksation,karnation,defibrillation,kollation,konneksion,dekomposition,eksplikation,konstriktion,apposition,emendation,hyperkorrektion,deeskalation,deskription,habituation,akkommodation,desertation,interpolation,demobilisation,derivation,vidimation,kontinuation,seriefabrikation,granulation,desorganisation,vindikation,akklimatisation,eksspiration,udkrystallisation,konsekration,konsignation,kanonisation,interpunktion,mumifikation,gyration,prænumeration,versifikation,relegation,retrospektion,reifikation,testation,inkorporation,kontribution,aggravation,konstipation,insideinformation,second opinion,relaksation,absentation,rektifikation,fundation,disjunktion,depilation,profanation,reduplikation,typifikation,legalisation,laktation,accession,graduation,retardation,science fiction,alternation,flagellation,S-station,amalgamation,perturbation,remonstration,rejektion,flotation,VVS-installation,amplitudemodulation,immobilisation,public relation,depersonalisation,incitation,denuntiation,transfiguration,kommutation,intimidation,stipulation,prolongation,snoozefunktion,diversion,derealisation,ekspatriation,kvintillion,rektion,justifikation,inkamination,degression,dekoncentration,demodulation,win-win-situation,slumrefunktion,gemination,elision,interpellation,kongestion,overstimulation,understimulation,kumulation,ondulation,indisposition,simplifikation,totalsituation,evaporation,godsekspedition,rekompensation,punktaktion,fabulation,disproportion,gradation,glorifikation,ovulation,demoralisation,okulation,generalisation,sideordningskonjunktion,bz-demonstration	stadion,symposion,prion
3	and	453	0.00443	333	120	mand,formand,vand,stand,afstand,brand,strand,tilstand,forstand,modstand,næstformand,påstand,talsmand,bestyrelsesformand,genstand,tand,målmand,købmand,gerningsmand,bistand,rådmand,landmand,gruppeformand,husstand,ombudsmand,velstand,embedsmand,rand,politimand,vismand,bagmand,julemand,forretningsmand,sodavand,franskmand,ægtemand,spand,nordmand,bestand,landsmand,skraldespand,grand,sømand,opstand,forbrugerombudsmand,tillidsmand,rigmand,udviklingsbistand,vandstand,undtagelsestilstand,dørmand,vognmand,konfirmand,ophavsmand,erhvervsmand,styrmand,videnskabsmand,førstemand,farmand,eksmand,ulandsbistand,stilstand,troldmand,drabsmand,finansmand,statsmand,overvismand,forligsmand,brandmand,sidemand,venstremand,voldsmand,bedemand,sandstrand,retsformand,hovedmand,menigmand,fællestillidsmand,skovbrand,badestrand,sportsmand,ejermand,akselafstand,arbejdsmand,redningsmand,enkemand,tjenestemand,husmand,ildebrand,ankermand,mellemmand,fagmand,lagmand,oldermand,lægmand,bombemand,helbredstilstand,pølsemand,snemand,adelsmand,spillemand,tredjemand,dannemand,fortand,danskvand,altmuligmand,skraldemand,folketingsmand,værdigenstand,foregangsmand,lærerstand,tissemand,bondemand,lydmand,vagtmand,verdensmand,flyttemand,levemand,handelsmand,vandmand,gåafstand,herremand,mordbrand,opmand,frømand,stiftamtmand,overmand,steppebrand,gråand,kødrand,stråmand,henstand,brormand,amtmand,banemand,brugsgenstand,våbenstilstand,begmand,spåmand,supermand,jernmand,hædersmand,domsmand,skønsmand,træmand,vildmand,vildand,befalingsmand,færgemand,havmand,eksaminand,gårdmand,blomsterstand,bondestand,choktilstand,koldbrand,handelsstand,mælkemand,murerarbejdsmand,kagemand,normaltilstand,privatmand,vurderingsmand,uforstand,hajtand,civilstand,ligemand,folketingsformand,hugtand,fragtmand,rigsombudsmand,sprællemand,anstand,medicinmand,afholdsmand,bussemand,lensmand,machomand,pyntegenstand,miltbrand,plovmand,dvaletilstand,gourmand,bøhmand,langemand,halsbrand,yngstemand,kontaktmand,mørkemand,tækkemand,middelstand,stormand,rorsmand,guttermand,lirekassemand,cykelafstand,dixieland,alvorsmand,fjerdemand,knudemand,ødeland,kindtand,papand,nissemand,vildtbestand,muskelmand,lygtemand,forstmand,patientombudsmand,doktorand,nipsgenstand,bådsmand,ægtestand,fritidslandmand,tændstikmand,chateaubriand,dykand,håndstand,guldbrand,førstestyrmand,nullermand,visdomstand,rapand,guldtand,hjemmelsmand,alarmtilstand,sørgerand,hjørnetand,grundvandsstand,morgenmand,flovmand,trancetilstand,rokketand,foderstand,løvetand,sædemand,gnidningsmodstand,analysand,fløderand,kællingetand,sendemand,forstrand,krikand,voldgiftsmand,stødtand,knokkelmand,tømmermand,synsmand,pekingand,høvedsmand,andenstyrmand,mælketand,urtilstand,fløjmand,motormand,pedalspand,buskmand,sidstemand,berberiand,gravand,gangafstand,observand,troldand,mineralvand,karamelrand,muselmand,klabautermand,udkigsmand,adelstand,mellemstand,sjælstilstand,valgmand,pibeand,sysselmand,dannebrogsmand,sårrand,moseand,synsrand,skeand,sjakformand,skydemodstand,græsenkemand,orlogsmand,undermand,dæksmand,frøkenstand,stifttand,håndværkerstand,onenightstand,bedstemand,proband,dressmand,hvinand,eftermand,galtetand,kraterrand,tamand,malkespand,riddersmand,præriebrand,jordemodermand,taffeland,fæstemand,fribadestrand,donkeymand,svømmeand,savtand,bjergand,ordinand,præparand,flytilstand,højvandstand,radikand,multiplikand,hjertespand,syns- og skønsmand,termometerstand,undertand,reeksaminand,aldersformand,støberand,frugtstand,tvetand,overtand,bylandmand,gør det selv-mand,habitualtilstand,harvetand,supervisand,alveolarrand,sandwichmand,frastand,skarnspand	land,vand,udland,brand,band,medlemsland,hjemland,kølvand,naboland,bagland,sand,farvand,udviklingsland,sodavand,fædreland,spand,drikkevand,euroland,grundvand,grænseland,uland,spildevand,indland,fastland,industriland,opland,sommerland,regnvand,østland,springvand,højland,badeland,saltvand,ingenmandsland,havvand,værtsland,badevand,saftevand,kildevand,jazzband,bigband,slaraffenland,modtagerland,tredjeland,ferskvand,moderland,tidevand,vandland,vesterland,legeland,danskvand,postevand,smeltevand,friland,broderland,tredjeverdensland,overfladevand,mundvand,kerneland,isvand,boyband,søhøjland,lavland,formandsland,kloakvand,punkband,kviksand,sæbevand,flyvesand,fjendeland,agerland,iland,brugsvand,kølevand,bøhland,brassband,territorialfarvand,klorvand,kondensvand,fostervand,buksevand,bjergland,brakvand,vestland,rosenvand,vievand,østerland,firspand,coverband,bundvand,drænvand,sletteland,forspand,steelband,forland,fladland,hundespand,skyllevand,heavyband,kvartssand,tevand,lydland,mineralvand,fladvand,kølnervand,kongevand,tospand,onenightstand,dybvand,varmtvand,morænesand,brygvand,grønsand,borvand,fødevand,idvand,rock and roll-band,fygesand,blegevand,tungtvand
3	hed	469	0.00363	469	0	virksomhed,mulighed,virkelighed,lejlighed,myndighed,sikkerhed,kærlighed,nyhed,frihed,opmærksomhed,begivenhed,sandhed,omstændighed,offentlighed,rettighed,nærhed,rådighed,enhed,arbejdsløshed,sundhed,menneskerettighed,usikkerhed,enighed,ytringsfrihed,hemmelighed,bevidsthed,lighed,helhed,personlighed,ledighed,sandsynlighed,tryghed,uenighed,hastighed,samvittighed,skønhed,anklagemyndighed,vanskelighed,nødvendighed,ulighed,svaghed,tålmodighed,stilhed,tavshed,retfærdighed,urolighed,menneskehed,menighed,tilfældighed,almindelighed,ensomhed,uafhængighed,faglighed,færdighed,beliggenhed,retssikkerhed,værdighed,klarhed,afhængighed,varighed,vittighed,ejerlejlighed,uvidenhed,forskellighed,evighed,stadighed,storhed,danskhed,elendighed,stridighed,herlighed,festlighed,betænkelighed,forkærlighed,tilbøjelighed,ligegyldighed,folkesundhed,bevågenhed,enkelhed,lethed,dygtighed,seværdighed,ulovlighed,forældremyndighed,dødelighed,uretfærdighed,vished,trafiksikkerhed,skarphed,dumhed,frihedsrettighed,sjældenhed,grusomhed,venlighed,berømthed,skævhed,tilgængelighed,kedsomhed,religionsfrihed,uregelmæssighed,selvfølgelighed,beskedenhed,næstekærlighed,uendelighed,konsulentvirksomhed,ømhed,ulejlighed,tilbageholdenhed,medlidenhed,velgørenhed,enkelthed,renhed,højtidelighed,uklarhed,færdselssikkerhed,pressefrihed,mindehøjtidelighed,høflighed,udholdenhed,beskaffenhed,villighed,fortræffelighed,frækhed,alsidighed,imødekommenhed,dobbelthed,ægthed,kulturpersonlighed,uhyrlighed,førlighed,hyppighed,fornødenhed,besværlighed,underbevidsthed,barmhjertighed,tophastighed,handlefrihed,skrøbelighed,knogleskørhed,servicevirksomhed,luftfugtighed,fjendtlighed,blufærdighed,meningsløshed,urimelighed,bevægelsesfrihed,voldsomhed,rigtighed,andelslejlighed,hårdhed,bekvemmelighed,lønsomhed,yderlighed,middelmådighed,usandhed,korthed,lyksalighed,valgmenighed,treenighed,knaphed,højhed,ubehagelighed,genvordighed,afdragsfrihed,overbærenhed,lydighed,væsentlighed,handlemulighed,finurlighed,ujævnhed,uansvarlighed,intethed,grovhed,tåbelighed,tvetydighed,læsefærdighed,særhed,vilkårlighed,lånemulighed,vedholdenhed,fortrædelighed,sigtbarhed,liderlighed,retsbevidsthed,luksuslejlighed,udødelighed,redelighed,afholdenhed,træghed,fuldkommenhed,børnedødelighed,smålighed,uskyldighed,selvmedlidenhed,frimenighed,utæthed,forlegenhed,urenhed,stoflighed,træfsikkerhed,lovmæssighed,åndelighed,specialenhed,stuelejlighed,morsomhed,råhed,dristighed,mærkværdighed,overdødelighed,spidsfindighed,uduelighed,tosomhed,agtpågivenhed,øvrighed,eftergivenhed,overdådighed,lejelejlighed,plathed,befolkningstæthed,underfundighed,ærgerrighed,straffrihed,gensidighed,herskabslejlighed,taknemlighed,nemhed,løntilbageholdenhed,bankhemmelighed,datasikkerhed,lobbyvirksomhed,brødremenighed,giftighed,tapperhed,umenneskelighed,metaltræthed,penthouselejlighed,salighed,overhøjhed,uforskammethed,godgørenhed,måleenhed,omhyggelighed,grimhed,veltalenhed,mindelighed,hulhed,trosfrihed,foreningsfrihed,kombinationsmulighed,kristenhed,almenhed,forlagsvirksomhed,trykkefrihed,taglejlighed,samdrægtighed,udsathed,kostbarhed,forladthed,behændighed,særegenhed,ondskabsfuldhed,vederstyggelighed,pudsighed,nedladenhed,gejstlighed,verdensnyhed,dybsindighed,behagelighed,spedalskhed,særrettighed,indforståethed,bestemthed,sprogfærdighed,spydighed,sprogvanskelighed,forudseenhed,uartighed,letsindighed,ejendommelighed,erkendtlighed,enkeltmandsvirksomhed,nederdrægtighed,møntenhed,voldelighed,yndighed,besynderlighed,uformåenhed,hæslighed,finhed,tankeløshed,udlændighed,kørelejlighed,dejlighed,stemmelighed,ubetydelighed,flothed,uanstændighed,elskværdighed,åndløshed,belæsthed,underlegenhed,bundethed,uforståelighed,moderkærlighed,flerhed,venskabelighed,sjofelhed,pointlighed,nedrighed,artighed,opgivenhed,smagløshed,marchhastighed,vidtløftighed,tyskhed,københavnerbegivenhed,håndgribelighed,skrivefærdighed,svagelighed,urørlighed,topnyhed,ubetænksomhed,gebrækkelighed,uhumskhed,ynkelighed,omstændelighed,tarvelighed,påholdenhed,ordholdenhed,godtroenhed,kvistlejlighed,flyvesikkerhed,åndfuldhed,ligegladhed,brevhemmelighed,direkthed,tjenestefrihed,tvistighed,enkeltbegivenhed,uundgåelighed,tilbageståenhed,pågåenhed,efterladenhed,jordbundethed,svenskhed,blaserthed,etværelseslejlighed,ringhed,spøgefuldhed,barnagtighed,skyldighed,åndssvaghed,bedrøvelighed,miskundhed,gemenhed,uforståenhed,drægtighed,uimponerethed,næringsfrihed,påtrængenhed,alvidenhed,afskyelighed,pligtopfyldenhed,urigtighed,prøvelejlighed,delelejlighed,appetitløshed,dødsstivhed,åndrighed,taktløshed,vægtenhed,djærvhed,toværelserslejlighed,smarthed,slibrighed,jævnhed,viderværdighed,mådeholdenhed,indesluttethed,strukturarbejdsløshed,trækningsrettighed,rettroenhed,vitterlighed,rigsenhed,nærtagenhed,velærværdighed,pseudobegivenhed,bevislighed,foderenhed,talefærdighed,pudseløjerlighed,byttelejlighed,ækelhed,tunghørhed,faderkærlighed,skibslejlighed,forrettighed,vejbeliggenhed,imponerethed,klublejlighed,ærværdighed,snurrighed,evindelighed,bekendthed,næsvished,stemmeflerhed,uægthed,artsmangfoldighed,ubundethed,halvhed,forårstræthed,trehed,højærværdighed,afsindighed,skændighed,løjerlighed,opfarenhed,tilhørighed,pseudonyhed,overlydshastighed,uformuenhed,umådeholdenhed,forekommenhed,farveægthed,gudsbevidsthed,sprogrigtighed,raskhed,formåenhed,tilbagetrukkenhed,velbårenhed,drøjhed,lavhed,beskyttelseslighed,kristenkærlighed,uvornhed,had-kærlighed,treværelserslejlighed,attråværdighed,torumslejlighed,firværelserslejlighed,nærgåenhed,femværelserslejlighed,fiffighed,modsvarighed,finholdighed,tyktflydenhed,viljesfrihed,smudsighed,typeenhed,plumphed,fireværelserslejlighed,stormægtighed,finskhed,betagethed,samsvarighed,indladenhed,trerumslejlighed,IT-virksomhed,sædighed,komplicerethed,IT-sikkerhed,halvandetværelseslejlighed,gudsforgåenhed,endrægtighed,sjælsstorhed,tyndtflydenhed,fremfusenhed,mængdeenhed,sjælsrenhed	
3	ter	680	0.00324	460	220	kilometer,meter,forfatter,minister,statsminister,datter,borgmester,karakter,computer,liter,udenrigsminister,centimeter,kvadratmeter,vinter,premierminister,mester,rytter,søster,finansminister,justitsminister,digter,kulturminister,millimeter,fortsætter,verdensmester,forsvarsminister,latter,skatteminister,deciliter,miljøminister,sundhedsminister,undervisningsminister,iværksætter,helikopter,indenrigsminister,lytter,overborgmester,fætter,cykelrytter,socialminister,erhvervsminister,reporter,psykiater,master,trafikminister,fødevareminister,parameter,slagter,politimester,økonomiminister,integrationsminister,lillesøster,transportminister,energiminister,viceborgmester,kubikmeter,stifter,udviklingsminister,tilflytter,oversætter,diameter,gangster,storesøster,egypter,medforfatter,kapelmester,kvadratkilometer,moster,kirkeminister,sværvægter,sprinter,forskningsminister,scooter,vogter,magister,landbrugsminister,bosætter,hjerter,sweater,boligminister,printer,tekstforfatter,pointer,målvogter,starter,balletmester,svigerdatter,forpagter,klimaminister,stormester,maskinmester,fighter,læremester,frankfurter,æter,kutter,transporter,krimiforfatter,tømrermester,hjertestarter,murermester,balter,beskytter,forvalter,lighter,malermester,bagermester,sætter,slagtermester,vicestatsminister,supporter,betragter,iscenesætter,headhunter,postmester,fangevogter,etter,ester,igangsætter,håndværksmester,medsøster,musketer,hofjægermester,vægter,redningshelikopter,fiskekutter,globetrotter,roadster,konkurrenceparameter,koncertmester,coaster,hjælperytter,bygmester,skater,dumpekarakter,brygmester,smutter,brandstifter,steddatter,tester,faster,besætter,kætter,mutter,eventyrdigter,glarmester,hjemmecomputer,afslutter,panter,opdrætter,tvillingesøster,militærnægter,snedkermester,medister,kopter,isvinter,pater,hamster,morter,etagemeter,snescooter,porter,snylter,halvsøster,ghettoblaster,otter,polyester,trendsætter,køter,babysitter,brødrister,letvægter,vandscooter,skarpretter,hyldemeter,webmaster,mavepuster,radiolytter,nægter,campylobacter,smedemester,milliliter,kelter,trompeter,blotter,tyrefægter,fatter,klister,varmemester,benægter,ceremonimester,fodermester,kaster,bitter,enakter,router,fægter,shelter,grønthøster,vagtmester,kvadratcentimeter,kassemester,børnepsykiater,konverter,sekundmeter,glaspuster,vægtløfter,fribytter,filister,lagerforvalter,bademester,hovmester,hektoliter,planter,linjevogter,godsforvalter,adapter,kloakmester,tekster,fagminister,kubikcentimeter,middelfarter,newtonmeter,dørvogter,ghostwriter,benytter,sprechstallmeister,jetsetter,toastmaster,centiliter,urostifter,rummeter,hånlatter,havnemester,kuwaiter,kryster,beretter,puster,weltervægter,flammekaster,fyrmester,skolemester,selvhenter,stjernekaster,spritter,spydkaster,transmitter,fraflytter,navnesøster,tonemester,udnytter,skræddermester,indflytter,goter,stedsøster,bytter,liguster,lommecomputer,folkekarakter,laserprinter,værkmester,mellemvægter,brandmester,frister,mikrometer,ritmester,tandbeskytter,supersværvægter,tater,skatmester,affugter,lyskaster,sæter,konkursrytter,væltepeter,layouter,knæbeskytter,klassementrytter,splatter,setter,spotter,udbytter,lyster,kældermester,dåselatter,udflytter,peanutbutter,flugter,hushovmester,kluklatter,teleprompter,kostforagter,plejedatter,fluevægter,religionsstifter,salpeter,fimbulvinter,udskifter,bantamvægter,diskoskaster,indskifter,scenemester,skuemester,toaster,grandfætter,paragrafrytter,filibuster,fægtemester,befragter,trøster,ledvogter,halvfætter,fæster,principrytter,kickstarter,baluster,opvarter,kvartermester,atomvinter,foragter,blikkenslagermester,dyneløfter,tabletcomputer,fornægter,halalslagter,showmaster,regelrytter,midvinter,pilaster,chancerytter,anstifter,bonusdatter,datterdatter,ildspåsætter,rister,poster,skridtbeskytter,opretter,herrnhuter,udsætter,spidsgatter,dummepeter,glasmester,materielforvalter,guddatter,skyter,selvstarter,gravemester,guldalderdigter,gearskifter,ensretter,røgter,gudsfornægter,nitter,cruiservægter,gudsbespotter,omskifter,styrkeløfter,perimeter,pædiater,decimeter,autoopretter,håndsætter,materialeforvalter,syngemester,plotter,skoggerlatter,korinter,papsøster,fredsstifter,slusemester,tremaster,defroster,ebeltofter,psalter,legatstifter,natvægter,søsterdatter,totakter,kaffesøster,lusepuster,pantsætter,tagrytter,afretter,fotosætter,ulster,frater,tugtemester,lægter,visedigter,snekaster,sønnedatter,gamemaster,lægsøster,støbemester,karmeliter,prøvemester,helsøster,gaslighter,firetakter,broderdatter,bordlighter,scripter,slagtemester,helflugter,languster,tonesætter,checkrytter,highlighter,komposter,indstifter,femmaster,evadatter,afkorter,beværter,befugter,rewriter,pjaster,cater,sinter,gørtlermester,cutter,toakter,presbyter,hektometer,gas- og vandmester,geriater,ryster,kanaster,boykotter,hipster,dekaliter,dekameter,tomaster,anholter,polyæter,raster,johanniter,norgesalpeter,guldsmedemester,singer-songwriter,skralderlatter,luskepeter,kilopondmeter,vigtigpeter,firemaster,blockbuster,halvflugter,pallelaster,kilogrammeter,vaskemester,kanister,chilesalpeter,caster,stråforkorter,dragster,gordonsetter,odedigter,vekselrytter,chatter	teater,center,kvarter,orkester,mønster,hovedkvarter,symfoniorkester,register,kloster,plejecenter,foster,asylcenter,parameter,monster,alter,filter,indkøbscenter,storcenter,ældrecenter,charter,semester,frikvarter,butikscenter,kulturcenter,musikteater,motionscenter,aktivitetscenter,universitetscenter,krisecenter,trækplaster,børneteater,plaster,barometer,villakvarter,fitnesscenter,dagcenter,egnsteater,kraftcenter,krater,dukketeater,kongrescenter,partikelfilter,slumkvarter,gitter,shoppingcenter,bycenter,taxameter,termometer,konkurrenceparameter,socialcenter,latinerkvarter,solcenter,traumecenter,hylster,konferencecenter,amatørteater,kateter,adfærdsmønster,datacenter,reaktionsmønster,amfiteater,folkeregister,epicenter,alkometer,misfoster,speedometer,bevægelsesmønster,polyester,synderegister,glitter,følelsesregister,jazzorkester,harmoniorkester,spekter,patronhylster,klister,totalteater,beredskabscenter,spisefrikvarter,rehabiliteringscenter,nikotinplaster,dydsmønster,shelter,callcenter,forstadskvarter,kontrolcenter,modtagecenter,newtonmeter,husalter,fantasifoster,scepter,kønsrollemønster,privatteater,fattigkvarter,strygeorkester,friluftsteater,hornorkester,marionetteater,handlingsmønster,personregister,nonnekloster,stegetermometer,voksenuddannelsescenter,parkometer,mikrometer,donorregister,kulturmønster,bombekrater,luftfilter,løbemønster,polster,jomfrukloster,nervecenter,trimester,udrejsecenter,urocenter,amatørorkester,gruppeteater,hæfteplaster,søvnmønster,salpeter,vulkankrater,højalter,tornyster,kølergitter,industricenter,omsorgscenter,spamfilter,kronometer,kulfilter,gråbrødrekloster,plekter,heksameter,skyldnerregister,voltmeter,solfilter,baluster,områdecenter,hjernecenter,snitmønster,rabarberkvarter,døgncenter,hulmønster,blæseorkester,amperemeter,strafferegister,cancerregister,intimteater,skyggeteater,manometer,ergometer,magnetometer,månekrater,eksperimentalteater,potentiometer,hygrometer,valgbarometer,seismometer,bolster,timecharter,spirometer,flitter,karmeliterkloster,ohmmeter,boulevardteater,digitaltermometer,variometer,kviksølvtermometer,støjfilter,bloster,harlekinmønster,natkvarter,farvespekter,sagsregister,wattmeter,paternoster,sagregister,fotometer,sømmometer,raster,johanniterkloster,vakuummeter,mesterjakelteater,pupillometer,takometer,pentameter,caféteater,aræometer,fløjalter,luxmeter,optometer,turnéteater,puppehylster,galvanometer,norgesalpeter,chilesalpeter,kapucinerkloster,gyrometer,fahrenheittermometer,densitometer,planimeter,hanefjedsmønster,AMU-center,telemeter,mediacenter,frøkenkloster,kabaretteater,celsiustermometer,p-plaster,jugendmønster,værkstedsteater,audiometer,goniometer,kviksølvbarometer,klyster,hydrometer,kalorimeter,narkometer,fuldregister,gulfilter
3	ent	274	0.00257	162	112	procent,præsident,patient,konkurrent,talent,betjent,producent,konsulent,agent,student,dirigent,klient,assistent,skribent,ministerpræsident,politibetjent,vicepræsident,korrespondent,event,chefkonsulent,komponent,abonnent,ekspedient,kræftpatient,accent,politiassistent,cement,tangent,interessent,cent,docent,regent,fængselsbetjent,skatteprocent,dissident,landbetjent,sergent,kriminalassistent,eksponent,specialkonsulent,kontorassistent,rengøringsassistent,kompliment,filmproducent,mælkeproducent,stemmeprocent,bistandsklient,advent,hjertepatient,orient,klassekvotient,kriminalbetjent,retspræsident,respondent,fedtprocent,klummeskribent,belægningsprocent,udvekslingsstudent,undervisningsassistent,klinikassistent,opponent,present,fagkonsulent,alderspræsident,krigskorrespondent,trækprocent,fejlprocent,oversergent,ambient,husassistent,butiksassistent,seniorsergent,koefficient,dobbeltagent,færdselsbetjent,resident,intelligenskvotient,referent,urobetjent,køkkenassistent,dumpeprocent,permanent,solvent,disponent,konseilspræsident,kvotient,fallent,retsbetjent,konsument,kasseassistent,spildprocent,sukkulent,biblioteksassistent,overbetjent,blodprocent,forlagskonsulent,togbetjent,transparent,understatement,telefonabonnent,rekvirent,kontrolassistent,chefsergent,civilbetjent,rekonvalescent,overpræsident,ækvivalent,eurocent,recipient,delinkvent,generalagent,gradient,plejeassistent,tronprætendent,folketingsbetjent,toldassistent,kommuneassistent,superintendent,handelsagent,subskribent,visent,parkinsonpatient,recensent,obducent,alzheimerpatient,bilassistent,differentialkvotient,postekspedient,kontrahent,socialassistent,terminalpatient,descendent,konstituent,laboratoriebetjent,prinsregent,kommittent,tilsynsassistent,ascendent,prætendent,fyrassistent,receptionsassistent,ministerialbetjent,intervenient,occident,IT-konsulent,SOSU-assistent,mordent,reagent,trassent,aids-patient,detergent,sygeplejeassistent,endossent,portlandcement,bruttotrækprocent,emittent,konsularagent,social- og sundhedsassistent,vol-au-vent,proponent,pønitent,rapidcement	arrangement,parlament,argument,talent,element,engagement,dokument,instrument,fundament,eksperiment,kontinent,management,temperament,patent,incitament,event,moment,monument,abonnement,supplement,bombardement,kontingent,segment,sortiment,signalement,fragment,departement,klassement,regiment,ræsonnement,medikament,konvent,kompliment,akkompagnement,avancement,establishment,etablissement,reglement,raffinement,livregiment,musikinstrument,bygningsreglement,møblement,statement,hovedargument,tankeeksperiment,naturtalent,traktement,ornament,slutdokument,pigment,måleinstrument,salgsargument,usikkerhedsmoment,sediment,strengeinstrument,pergament,settlement,overraskelsesmoment,blæseinstrument,firmament,gravmonument,subkontinent,divertissement,tæppebombardement,trænregiment,jugement,transparent,soloinstrument,understatement,strygeinstrument,forlystelsesetablissement,ækvivalent,rudiment,ressentiment,lavement,filament,rytmeinstrument,tangentinstrument,detachement,deplacement,komplement,avertissement,liniment,slaginstrument,guvernement,irritament,assortiment,disengagement,garderegiment,possement,husarregiment,ferment,nivellement,springavancement,detergent,konnossement,ekskrement,incident,zinkliniment,enjambement,ligament,emolument,changement,endossement,tørelement,postament,kantonnement,piment,lineament,termoelement,åbent hus-arrangement
3	ang	204	0.00225	188	16	gang,sang,omgang,adgang,fremgang,udgang,tilgang,afgang,indgang,årgang,overgang,tankegang,gennemgang,trang,nedgang,tilbagegang,skolegang,klang,tvang,opgang,stang,tang,hang,vang,undergang,fællessang,modgang,arbejdsgang,solnedgang,balancegang,rang,tomgang,spang,opsang,genklang,enegang,svalegang,vrang,lønnedgang,rettergang,popsang,flagstang,solopgang,slang,nationalsang,græsgang,boomerang,sejrsgang,korsang,løftestang,samklang,medgang,slagsang,efterklang,klagesang,vognstang,forretningsgang,fiskestang,ramasjang,forrang,mustang,øregang,landgang,børnesang,internetadgang,salmesang,trappeopgang,stavgang,orangutang,bortgang,gearstang,rundgang,kirkegang,aftensang,fodgængerovergang,lediggang,folkesang,nødudgang,lovsang,titelsang,kavalergang,fødegang,svanesang,midtergang,stuegang,skønsang,bølgegang,bodsgang,sagsgang,bagindgang,protestsang,ildtang,holmgang,kapgang,søgang,altergang,tiggergang,forgang,netadgang,fædrelandssang,ordretilgang,rumklang,postgang,festsang,svang,solosang,virketrang,dybgang,handlingsgang,gospelsang,alsang,søjlegang,sædafgang,minegang,buegang,gåsegang,bersærkergang,tandstang,vægtstang,trappegang,treklang,vandgang,løbegang,gardinstang,baggang,toggang,bjældeklang,visumtvang,selvstændighedstrang,løngang,irgang,godnatsang,blæretang,saltstang,rørtang,majstang,knibtang,sneglegang,bagudgang,skridtgang,pasgang,teltstang,plejlstang,rapsang,vekselsang,besiddertrang,arvegang,armgang,sukkertang,målstang,bidetang,rumsterstang,købetvang,altangang,tonegang,scatsang,pisang,bændeltang,biklang,borgmesterstang,figenstang,rundesang,firklang,hultang,frugtstang,lodstvang,regnfang,papegøjetang,riffelgang,udklang,fladtang,gnistfang,canossagang,niptang,skabsgang,skruegang,tromlegang,frankotvang,blodgang,åregang,vindelgang,koromgang,rotang,universaltang,bramstang,sargassotang,refrænsang,walesstang	omfang,hang,slang,blikfang,vingefang,ramasjang,rumfang,vindfang,forfang,bladhang,støvfang,løvhang,klingklang,forprang,gnistfang,sandfang
3	der	593	0.00184	537	56	leder,forælder,medarbejder,alder,modstander,vinder,fader,skulder,kælder,anmelder,arbejder,englænder,skoleleder,skatteyder,kalender,morder,middelalder,forstander,projektleder,hollænder,forbryder,bedsteforælder,partileder,spejder,kurder,udbyder,begynder,foredragsholder,ridder,broder,kender,under,grønlænder,pensionsalder,hæder,inder,forfader,sludder,tidsalder,regeringsleder,topleder,julekalender,skibsreder,afsender,vejleder,holder,statsleder,outsider,synder,speeder,opfinder,folder,tolder,menneskealder,gennemsnitsalder,guldalder,beholder,sladder,centerleder,bartender,redder,ruder,krigsforbryder,jordemoder,cylinder,mellemleder,stedfortræder,lavalder,nybegynder,indsatsleder,naturvejleder,sjællænder,vender,livmoder,levealder,stenalder,bogholder,sender,tovholder,finder,forræder,matchvinder,skrædder,seriemorder,lejemorder,maskinarbejder,rejseleder,pokalvinder,jernalder,udbryder,koriander,vædder,massemorder,driftsleder,fadder,bryder,studievejleder,bløder,livredder,blender,bronzealder,skovrider,gæstearbejder,fjeder,socialarbejder,overgangsalder,bisidder,bygningsarbejder,landsforræder,prisvinder,stander,landarbejder,sølvvinder,odder,højskoleforstander,vinkælder,insider,korleder,garder,gråbroder,livsnyder,snyder,mønsterbryder,gruppeleder,hjælpearbejder,havnearbejder,reder,tempelridder,landsfader,kampagneleder,internetudbyder,specialarbejder,stationsleder,enspænder,kuglestøder,isbryder,industriarbejder,filmanmelder,metalarbejder,cider,brænder,lovovertræder,talentspejder,østarbejder,slider,forhandlingsleder,fabriksarbejder,flyder,indskyder,servicemedarbejder,kursusleder,flyveleder,turbolader,fremmedarbejder,vinterbader,thailænder,lykkeridder,afbrænder,bryggeriarbejder,fartsynder,skovarbejder,tilbeder,bodybuilder,mødeleder,lader,sokkeholder,stodder,lagerarbejder,pigespejder,skyder,dekoder,offroader,selvmorder,forkynder,arbejdsleder,sexforbryder,nyder,yder,stamfader,fastholder,langelænder,oplader,fender,brander,klanleder,indsender,lovbryder,korsridder,kommunikationsmedarbejder,newzealænder,migrantarbejder,abortmodstander,afbryder,skattesnyder,underholder,kulkælder,vaneforbryder,statholder,voldsforbryder,forårsbebuder,ynder,kilder,postarbejder,voksenalder,skadevolder,bogbinder,sortebroder,slavearbejder,ladestander,stifinder,stationsforstander,senmiddelalder,salamander,børnearbejder,støder,programleder,funktionsleder,reminder,æggeleder,bølgebryder,lønarbejder,teltholder,rekordholder,berider,krybekælder,besidder,kunstkender,helleflynder,byggearbejder,tænder,glider,ilder,kulminearbejder,stenbider,tekstilarbejder,medaljevinder,køkkenleder,mikrofonholder,seksualforbryder,løsarbejder,formynder,hypokonder,indleder,snigmorder,tender,oversidder,jernbanearbejder,kopholder,gasbeholder,værtshusholder,stavblender,lynafleder,planteæder,renovationsarbejder,islænder,forlader,kirkefader,halvleder,skærebrænder,vinkender,formoder,udsteder,erhvervsvejleder,flamlænder,superleder,pakkekalender,udsmider,ungarbejder,sveder,brystholder,hofteholder,opstander,spreder,velynder,ugander,benzinstander,kommunalarbejder,støjsender,højmiddelalder,bidragsyder,rwander,bænkebider,fyrbøder,våbenbroder,stadeholder,menneskekender,førskolealder,cykelkælder,misdæder,fremmedhader,pladevender,flynder,indbyder,kompostbeholder,krydder,banebryder,dødbider,palisander,sumobryder,grinebider,kødæder,myndighedsalder,ekspander,brigader,overtræder,landevejsridder,selvbinder,binder,blomsterbinder,auktionsleder,medvider,søspejder,påklæder,dameskrædder,samværsforælder,menneskeæder,kvindehader,humørspreder,kerteminder,rigsforstander,helbreder,barnefader,irlænder,kulturarbejder,kloakarbejder,grovæder,arvelader,rovmorder,æblecider,lystmorder,morgenkrydder,barnealder,paraglider,hyggespreder,distanceblænder,bopælsforælder,ordskvalder,kørselsleder,suder,newfoundlænder,lejder,ceder,solbader,bunsenbrænder,voksealder,saltspreder,bekender,kortudsteder,fremkalder,skriftefader,trodsalder,blodbroder,gralsridder,stammoder,nederlænder,strømpeholder,atomalder,brandmelder,afrydder,kvidder,ådselæder,gyllespreder,spinder,skydebroder,fribryder,nøgenbader,bebuder,burgunder,ringsteder,stålfjeder,vrider,lømmelalder,drømmetyder,efterbrænder,grunder,rusvejleder,familievejleder,edder,trykkeriarbejder,betonblander,kontaktforælder,børstenbinder,ludder,skolopender,lyseholder,stjernetyder,kvader,smittespreder,teaterskrædder,pælesidder,brændevinsbrænder,sengevæder,åndsarbejder,fostbroder,cigartænder,toårsalder,elefantridder,oleander,lollænder,drivfjeder,mordbrænder,fortynder,vodbinder,skævbider,singleforælder,opinionsleder,estlænder,planlægningskalender,fyrkælder,kernebider,giftblander,strejkebryder,nodevender,kortbølgesender,smælder,hangglider,forrider,insektæder,evighedskalender,husholder,tchader,gødningsspreder,praktikleder,stedforælder,sarder,biæder,varmeleder,skvalder,spiralfjeder,glimtænder,lægbroder,højlænder,lappeskrædder,isoleringsarbejder,udviklingsmedarbejder,indsidder,menneskehader,ordgyder,teglbrænder,grenader,selvmøder,stenvender,rugemoder,trussereder,viktualiekælder,shetlænder,marketender,gastænder,småbørnsforælder,partreder,ekstraarbejder,springfjeder,rheinlænder,overkrydder,barnemoder,gotlænder,kapverder,frederikssunder,grusspreder,vandudlader,baglader,narkoludder,bøgespinder,toiletpapirholder,oprydder,blokkalender,finlænder,moder,FM-sender,ekstruder,højforræder,udlader,værnepligtsalder,ringrider,påminder,sliddersladder,grubearbejder,svejsebrænder,cheerleader,jord- og betonarbejder,meneder,knivafbryder,civilarbejder,skryder,minerydder,nysteder,CD-brænder,dodder,swazilænder,underkrydder,vader,benedder,æder,wakeboarder,godsbesidder,afleder,næstveder,fribader,surfrider,afkoder,pelsbereder,højder,TV-anmelder,tospænder,krybbebider,penselspinder,IT-medarbejder,laplænder,kornsmælder,christiansfelder,sagvolder,eftersidder,slagfjeder,faddersladder,nulleder,plænevander,bulbider,bjørnespinder,husfader,vindbryder,arkføder,byldemoder,urfjeder,vårbebuder,cementblander,kropsarbejder,skateboarder,trykfjeder,trinidader,ungpigealder,vandtræder,skvadder,blander,ildlænder,ringspinder,fosterfader,bælgetræder	under,foder,sludder,mudder,læder,tønder,mylder,vidunder,gelænder,kateder,kludder,bulder,smadder,fnidder,pladder,dunder,menneskemylder,pudder,viskelæder,rabalder,personfnidder,barnemorder,kraftfoder,fiskefoder,palisander,tørfoder,hundefoder,fnadder,ordskvalder,tankemylder,kernelæder,overlæder,grovfoder,pludder,kvidder,mundlæder,plidderpladder,polyeder,sålelæder,skvalder,tetraeder,fuldfoder,oktaeder,gyldenlæder,bøffellæder,presfoder,pjadder,talkumpudder,heksaeder,grønfoder,skvadder,svinelæder,pentaeder,sliddersladder,dekaeder,gnidder
3	dag	122	0.00179	122	0	søndag,lørdag,fredag,mandag,torsdag,onsdag,tirsdag,eftermiddag,hverdag,formiddag,fødselsdag,middag,gårsdag,dagligdag,arbejdsdag,skoledag,helligdag,fridag,juledag,årsdag,sommerdag,forbundsdag,morgendag,landdag,sygedag,mærkedag,festdag,dommedag,påskedag,spilledag,rigsdag,førstedag,temadag,grundlovsdag,hviledag,skærtorsdag,lukkedag,langfredag,bryllupsdag,nytårsdag,nationaldag,bededag,pinsedag,børnefødselsdag,torvedag,ugedag,omsorgsdag,dødsdag,sidstedag,markedsdag,børnehjælpsdag,flyttedag,flagdag,valentinsdag,palmesøndag,skiftedag,påskelørdag,feriefridag,idrætsdag,valdemarsdag,karensdag,pinselørdag,graddag,skæringsdag,allehelgensdag,lillejuleaftensdag,parmiddag,skuddag,tiårsdag,konfirmationsdag,navnedag,fastedag,liggedag,billigdag,adventssøndag,askeonsdag,hundredårsdag,genforeningsdag,fastelavnsmandag,søgnedag,løbedag,forfaldsdag,søgnehelligdag,helligtrekongersdag,mikkelsdag,månedsdag,mortensdag,sankthansdag,allesjælesdag,fristdag,øvdag,etårsfødselsdag,glædesdag,ottetimersdag,attenårsfødselsdag,åbent hus-dag,trediveårsfødselsdag,nittenårsfødselsdag,overliggedag,tychobrahesdag,j-dag,halvfjerdsårsfødselsdag,p-dag,manddag,Mariæ bebudelsesdag,fjortenårsfødselsdag,syttenårsfødselsdag,tresårsfødselsdag,halvtredsårsfødselsdag,D-dag,trettenårsfødselsdag,klippe-klistre-dag,tolvårsfødselsdag,lørdag-søndag,fyrreårsfødselsdag,halvfemsårsfødselsdag,tyveårsfødselsdag,sekstenårsfødselsdag,Kristi himmelfartsdag,femtenårsfødselsdag,firsårsfødselsdag,treårsfødselsdag	
3	nde	264	0.00172	214	50	kvinde,kunde,ende,studerende,runde,veninde,fjende,pårørende,vinde,bonde,pande,bande,slutrunde,sinde,sangerinde,tønde,legende,henseende,skuespillerinde,kende,elskerinde,kande,grevinde,talskvinde,tinde,heltinde,værtinde,rejsende,fyringsrunde,sparerunde,nethinde,bordende,øverstkommanderende,næstkommanderende,rende,gudinde,ånde,lærerinde,tidende,forfatterinde,krudttønde,ynde,blonde,mellemrunde,opdagelsesrejsende,bradepande,bagende,sonde,svigerinde,lærerstuderende,stamkunde,tagrende,kejserinde,arvefjende,vinbonde,slimhinde,danserinde,jurastuderende,karrierekvinde,termokande,hertuginde,risalamande,forhandlingsrunde,storkunde,hynde,forkvinde,stegepande,forretningsrejsende,hinde,rumsonde,guirlande,uddannelsessøgende,reprimande,forretningskvinde,medstuderende,trommehinde,dividende,sejlrende,åkande,handelsrejsende,erhvervskvinde,olietønde,forstanderinde,forende,dødsfjende,tyvebande,hornhinde,dronningerunde,fodende,frænde,husbestyrerinde,vandkande,grande,tjenerinde,rotunde,tekande,æresrunde,magtbrynde,løvinde,røverbande,ophavskvinde,troldkvinde,lunde,blænde,bedsteveninde,fribonde,prikkerunde,rivalinde,herskerinde,mynde,fyrstinde,stempelkande,pianistinde,slyngveninde,vandrende,hyrdinde,kammerherreinde,slavinde,ferierejsende,tillidskvinde,præstinde,skaldepande,boligsøgende,hjerteveninde,balletdanserinde,helgeninde,foregangskvinde,mavedanserinde,selvstuderende,jomfruhinde,kunstnerinde,priorinde,gemalinde,videnskabskvinde,digterinde,sportskvinde,fæstebonde,forligskvinde,fastelavnstønde,forskerstuderende,adelskvinde,granguirlande,strøgkunde,violinistinde,trælkvinde,hjernehinde,kontrabande,penneveninde,skotrende,rådkvinde,vunde,fosterhinde,kvajpande,stammefrænde,demimonde,konsulinde,sarabande,rollehavende,regnbuehinde,bestyrerinde,skæbnegudinde,blende,fløjtetønde,bughinde,sauterepande,vestalinde,månesonde,tiende,benende,lungehinde,kærminde,vånde,saucekande,provstinde,hovbonde,pastorinde,ulvinde,begblende,smørekande,gifttønde,tande,andetårsstuderende,fjernstuderende,senehinde,lystønde,blinkhinde,bindehinde,agende,zinkblende,tamarinde,modlysblænde,skedehinde,førstedelsstuderende,ph.d.-studerende,solblænde,kursusstuderende,hornblende,logerende,elende,infantinde,irisblænde,konfirmandinde,kongebonde,pytipande,andendelsstuderende,indsande,allemande,førsteårsstuderende,garnvinde,flyværtinde,handlende,dannekvinde,konventualinde,audienssøgende	vedkommende,minde,udseende,anliggende,ærinde,vidende,foretagende,brænde,forlydende,onde,forehavende,tilgodehavende,velbefindende,særkende,dødvande,forgodtbefindende,allehånde,pålydende,fortidsminde,mellemværende,spænde,højvande,indestående,lavvande,ildebefindende,svinkeærinde,maveonde,tyende,udestående,forlangende,pindebrænde,bæltespænde,tilliggende,anbringende,foregivende,hårspænde,andragende,befindende,indseende,dybgående,byærinde,bøgebrænde,jammersminde,almenbefindende,elende,præbende,indsande,udvisende,hjerteonde,velgående
3	one	78	0.00169	77	1	krone,kone,tone,zone,trone,skattekrone,drone,undertone,ekskone,gråzone,farezone,lysekrone,anemone,overtone,omgangstone,grundtone,randzone,silikone,trækrone,byzone,landzone,kogekone,ringetone,spåkone,amazone,done,gråtone,farvetone,bondekone,trombone,hyletone,bufferzone,mellemtone,scone,vågekone,acetone,kammertone,fiskerkone,søanemone,grædekone,mosekone,vaskekone,klimazone,femkrone,matrone,enkrone,prismekrone,tissekone,tornekrone,hjulkrone,tokrone,klartone,minestrone,kejserkrone,tikrone,lammekrone,cicerone,kagekone,chaperone,none,stillezone,yderzone,canzone,husmandskone,halvtone,calzone,summetone,digekrone,kvarttone,inderzone,smartphone,jacketkrone,grevekrone,trevlekrone,normaltone,heltone,amarone	hole-in-one
3	old	156	0.00160	73	83	fodbold,vold,bold,håndbold,told,skjold,fold,trold,knold,kvindehåndbold,herrehåndbold,topfodbold,snebold,kastebold,charmetrold,herold,grundvold,jordvold,dødbold,hustruvold,landsholdsfodbold,støjvold,tennisbold,sætbold,skærmtrold,sold,fjerbold,rundbold,bordfodbold,gadevold,badebold,bondeknold,returbold,pressefold,indefodbold,boksebold,gadefodbold,rodknold,stopbold,enfold,gummibold,hoppebold,andenbold,stikbold,æresvold,støvbold,manifold,fårefold,hedenold,fennikelknold,medievold,basketbold,langbold,pengefodbold,videovold,georgineknold,selleriknold,beskyttelsestold,volleybold,nakkefold,netbold,buksetrold,ståtrold,åretold,bruskbold,vægttold,hidsigtrold,slyngbold,præferencetold,dropbold,løgknold,proffodbold,transittold	forhold,hold,indhold,landshold,ophold,hjemmehold,forbehold,sammenhold,tophold,parforhold,medhold,skjold,tilhørsforhold,fold,førstehold,fodboldhold,bundhold,rejsehold,mesterhold,andethold,udehold,studieophold,kærlighedsforhold,misforhold,vedligehold,magtforhold,styrkeforhold,mådehold,missilskjold,tæskehold,baghold,håndboldhold,våbenskjold,tillidsforhold,parkeringsforhold,træningsophold,seniorhold,tilhold,juniorhold,underhold,elitehold,førerhold,dyrehold,sold,polititilhold,nathold,kontraktforhold,produktionsforhold,husdyrhold,kurophold,skiftehold,bytteforhold,leveforhold,iltindhold,skudhold,gudsforhold,tredjehold,bombeskjold,hushold,kvæghold,kolesterolindhold,kontorhold,modtageforhold,langdistanceforhold,svinehold,sagforhold,snold,førstedivisionshold,fuglehold,umådehold,avishold,modhold,krohold,mangefold,hjortehold,signal-støj-forhold,renhold,C-hold,A-hold,fladeindhold,had-kærligheds-forhold,hofhold,B-hold
3	und	137	0.00154	91	46	grund,baggrund,hund,bund,sekund,mund,stund,undergrund,afgrund,morgenstund,byggegrund,grobund,havbund,lund,indvandrerbaggrund,vagthund,forgrund,skovbund,bevæggrund,sound,kamphund,gravhund,klangbund,politihund,jordbund,kistebund,hovedbund,svinehund,mårhund,schæferhund,jagthund,nabogrund,muskelhund,førerhund,slædehund,skødehund,sporhund,hanhund,bækkenbund,puddelhund,vandhund,trutmund,naturgrund,klippegrund,bombehund,lagkagebund,overmund,undermund,giftgrund,blodhund,slikmund,hønsehund,hunhund,ulvehund,aftenstund,hårbund,ølhund,slagterhund,lænkehund,fårehund,sælhund,stengrund,sanktbernhardshund,resonansbund,vovhund,surroundsound,præriehund,artiskokbund,spidshund,koteletgrund,tævehund,mosebund,skilsmissegrund,dødsstund,torskemund,løvemund,lækkermund,vogterhund,lamelbund,pladshund,surbund,rundmund,svejshund,sangbund,grævlingehund,korund,blund,spiralbund,tværmund,greyhound,trevlemund	samfund,sekund,forbund,fund,pund,velfærdssamfund,lokalsamfund,sund,trossamfund,verdenssamfund,retssamfund,påfund,valgforbund,splitsekund,parallelsamfund,informationssamfund,landsbysamfund,specialforbund,oplysningsforbund,klassesamfund,overvågningssamfund,forbrugersamfund,vidensamfund,millisekund,øsamfund,statssamfund,risikosamfund,nanosekund,statsforbund,nærsamfund,gravfund,mosefund,kommunikationssamfund,mandssamfund,sprogsamfund,mikrosekund,listeforbund,jordfund,skålpund,totredjedelssamfund,lispund,alternativsamfund,lavvækstsamfund,blund,wattsekund,skippund
3	ker	461	0.00153	440	21	dansker,politiker,forsker,tysker,musiker,kritiker,analytiker,håndværker,historiker,klassiker,svensker,fisker,iraker,akademiker,rocker,komiker,tekniker,makker,græker,dramatiker,elsker,parlamentariker,tænker,alkoholiker,seniorforsker,mekaniker,skeptiker,kommunalpolitiker,fysiker,lokalpolitiker,elektriker,oprykker,aktieanalytiker,keramiker,toppolitiker,efterforsker,kunsthistoriker,nydansker,grafiker,playmaker,dykker,joker,hacker,hersker,lystfisker,afstikker,jazzmusiker,bødker,snedker,fanatiker,lyriker,firehjulstrækker,apoteker,trækker,poker,systemkritiker,kunsthåndværker,matematiker,tanker,bunker,bookmaker,romantiker,kemiker,fremtidsforsker,valgforsker,hjerneforsker,rockmusiker,diabetiker,klimaforsker,rykker,medieforsker,speaker,aftrækker,teoretiker,skruetrækker,nedrykker,fortolker,optiker,forstærker,stikker,sprogforsker,udlandsdansker,praktiker,newyorker,kyniker,landspolitiker,allergiker,psykoanalytiker,punker,kunstkritiker,botaniker,litteraturkritiker,nøddeknækker,supertanker,statistiker,automekaniker,møbelsnedker,perker,bioanalytiker,satiriker,dyrker,pragmatiker,astrofysiker,mejetærsker,feinschmecker,filharmoniker,pacemaker,basker,mystiker,polarforsker,undertrykker,husker,appetitvækker,kroniker,enehersker,krænker,nyklassiker,taktiker,trykker,atomfysiker,europaparlamentariker,idéhistoriker,biker,religionshistoriker,røgdykker,dranker,vinduesvisker,opvasker,lukker,nostalgiker,magiker,shaker,indpisker,biokemiker,levebrødspolitiker,symfoniker,excentriker,klokker,junker,genetiker,fritænker,flymekaniker,proptrækker,sportsfisker,knivstikker,kammermusiker,børnelokker,naturforsker,religionsforsker,okker,æstetiker,bogtrykker,kræftforsker,tandtekniker,popmusiker,usbeker,franker,førsteelsker,klimaskeptiker,plukker,pulverslukker,fluesmækker,spastiker,datamatiker,brandslukker,azteker,murbrækker,kliniker,prædiker,folkemusiker,lydtekniker,geofysiker,kriminaltekniker,slukker,kammerjunker,polemiker,backpacker,lyseslukker,kønsforsker,astmatiker,kulturhistoriker,visker,etiker,trucker,udenlandsdansker,standupkomiker,stinker,gammeldansker,bygningshåndværker,neurotiker,miljøtekniker,melankoliker,slægtsforsker,kirkehistoriker,agnostiker,dobbeltdækker,ironiker,snooker,fusker,fredsforsker,lappedykker,epileptiker,etrusker,stivstikker,kødhakker,genforsker,rigsstatistiker,fyrværker,industritekniker,maskintekniker,maveplasker,realpolitiker,betablokker,høker,bluesmusiker,stalker,hjemmetysker,naturhistoriker,bygningssnedker,forhjulstrækker,føniker,kvæker,skruebrækker,skumslukker,tagdækker,elektronikmekaniker,scenetekniker,stoiker,kaffedrikker,sticker,fluefisker,ildslukker,vasker,semiotiker,byggetekniker,strandvasker,sportsdykker,eftersnakker,finmekaniker,typotekniker,løntrykker,choker,gnostiker,laboratorietekniker,oplukker,rakker,øloplukker,navneforsker,hysteriker,logiker,søvnforsker,samtidshistoriker,spytslikker,lokker,behersker,industrifisker,dogmatiker,mimiker,logistiker,læseforsker,tadsjiker,soldyrker,nationalromantiker,grundforsker,koleriker,folkemindeforsker,systematiker,smagsforstærker,opkvikker,senromantiker,strikker,tedrikker,lemmedasker,kratlusker,erotiker,knoldesparker,trekker,kernefysiker,konfliktforsker,egocentriker,pisker,tolker,heraldiker,havfisker,skallesmækker,tæppebanker,agerdyrker,kobberstikker,stoftrykker,kapelmusiker,kukker,svømmedykker,perlefisker,slavepisker,kvartalsdranker,geokemiker,elektrotekniker,gastanker,kulsukker,punkrocker,metafysiker,gransker,teletekniker,spækhøker,heavyrocker,stenfisker,monegasker,speedmarker,morakker,kosmetiker,finlandssvensker,flegmatiker,skovtekniker,numismatiker,polytekniker,obstetriker,platoniker,stjerneskruetrækker,afatiker,pølsetysker,ditmarsker,empiriker,gibbernakker,grammatiker,kemotekniker,migræniker,fuldblodspolitiker,geotekniker,helsefysiker,lusker,eklektiker,holbækker,sangviniker,stenpikker,projektforsker,syfilitiker,sidemakker,mellemtekniker,tagtækker,diagnostiker,aldersdiabetiker,frederiksværker,fonetiker,udstykker,byggehåndværker,tærsker,hermeneutiker,persillehakker,oldgransker,nyromantiker,forforstærker,cyberpunker,todækker,socialhistoriker,kiropraktiker,hjulpisker,selvplukker,optrækker,idylliker,branddasker,dialektiker,kulsyreslukker,nekromantiker,dørlukker,pyrotekniker,voldsromantiker,kedelflikker,offsettrykker,malker,angstneurotiker,spaltelukker,hardrocker,marker,vandskrækker,VVS-tekniker,apoplektiker,solblokker,aritmetiker,prosaiker,oratoriker,asteniker,hæretiker,shelterdækker,madagasker,skolastiker,prognostiker,paralytiker,indpakker,karismatiker,epiker,bulimiker,cøliaker,tækker,silketrykker,telemekaniker,fetichdyrker,skulker,rokker,reumatiker,elektroniker,fjernsynstekniker,diætetiker,metodiker,epigrafiker,statiker,kanalforstærker,geobotaniker,slaveforstærker,ortorektiker,pantomimiker,elegiker,skismatiker,vækker,personalhistoriker,kiromantiker,blasfemiker,tragiker,retoriker,maniker,didaktiker,lybækker,højromantiker,anorektiker,hektiker,esmakker,rudevasker,chanker,økumeniker,udrykker,dyslektiker,pakker,psykotekniker,krybfisker,poselukker,pykniker,akustiker,semantiker,dysfatiker,homiletiker,tredækker	sukker,blodsukker,anker,rørsukker,maveplasker,druesukker,puddersukker,mælkesukker,florsukker,frugtsukker,perlesukker,strøsukker,drivanker,råsukker,roesukker,invertsukker,kandissukker,krystalsukker,varpanker,hækanker,demerarasukker
3	kke	192	0.00152	134	58	række,klokke,løkke,ulykke,årrække,pakke,lykke,bakke,nakke,jakke,dukke,madpakke,krukke,trafikulykke,tjekke,frakke,sprække,hjælpepakke,vækstpakke,perlerække,flække,dødsulykke,brevsprække,alarmklokke,krykke,læderjakke,kirkeklokke,dørklokke,hakke,vindjakke,kongerække,lovpakke,krisepakke,rokke,foredragsrække,drukneulykke,brokke,syltekrukke,regnfrakke,osteklokke,overfrakke,solsikke,færdselsulykke,dynejakke,højresvingsulykke,indbakke,marionetdukke,kælkebakke,nykke,nikkedukke,løvstikke,tankerække,sejrsrække,krikke,krigslykke,galgebakke,knagerække,påklædningsdukke,ringeklokke,soloulykke,æggebakke,talrække,tweedjakke,dunjakke,dykkerklokke,hikke,kludedukke,medietække,budstikke,glasklokke,mokke,hånddukke,mesterrække,eneulykke,foliebakke,kattebakke,snekke,kvindetække,båtnakke,nøkke,publikumstække,fejebakke,tallerkenrække,voksdukke,skihopbakke,fleecejakke,dørsprække,tyrenakke,skærmtække,vikke,handskedukke,tekstrække,stivnakke,stormklokke,blåklokke,kindbakke,præsenterbakke,bremsebakke,diplomatfrakke,smakke,småpakke,hopbakke,skødefrakke,slaskedukke,brødbakke,værdipakke,dirigentklokke,børnetække,sømrokke,udbakke,mæfikke,figurfrakke,dametække,tåbenakke,tistykspakke,potensrække,skabekrukke,hundetække,altvejrsjakke,fodervikke,tække,kampjakke,overgangsjakke,kvotientrække,aleneulykke,tyvestykspakke,smørkrukke,alabasterkrukke,teddybearfrakke,flaskebakke,musevikke,primadonnanykke,herretække,softshelljakke	stykke,lukke,smykke,regnestykke,dække,teaterstykke,samtykke,sidestykke,tilløbsstykke,modstykke,rundstykke,brudstykke,viskestykke,kunststykke,aktstykke,musikstykke,mesterstykke,indelukke,arvestykke,svendestykke,skydække,udstyrsstykke,lærestykke,sætstykke,klippestykke,jordstykke,topstykke,aflukke,bunddække,halssmykke,mundstykke,rygstykke,livstykke,sofastykke,vovestykke,pragtstykke,isdække,medietække,midterstykke,kvindetække,bærestykke,publikumstække,sprængstykke,fodstykke,skærmtække,linjestykke,similismykke,børnetække,gangestykke,dametække,kronestykke,topassmykke,herretække,forlængerstykke,hundetække,schallstykke,tykke,tække
3	ger	449	0.00148	438	11	borger,vælger,deltager,forbruger,finger,indbygger,bruger,passager,sanger,tilhænger,sælger,lønmodtager,manager,ansøger,teenager,forgænger,anklager,statsborger,asylansøger,lager,modtager,iagttager,jæger,ryger,tiger,efterfølger,trommeslager,initiativtager,kriger,bager,grundlægger,billedhugger,medborger,skatteborger,asylsøger,pegefinger,burger,forsanger,misbruger,beslutningstager,fodgænger,ringer,forlægger,østriger,spørger,tommelfinger,operasanger,arbejdstager,stryger,ledsager,stofmisbruger,arvtager,overligger,svoger,ballademager,genganger,løsgænger,sagsøger,klager,prismodtager,kirkegænger,båndoptager,støvsuger,forfølger,neger,aftager,slinger,låntager,forsørger,ager,håndlanger,tigger,springer,brygger,følger,planlægger,sydslesviger,samfundsborger,kigger,budbringer,kernevælger,urmager,anger,blogger,biografgænger,søger,gidseltager,blikkenslager,bjergbestiger,opfølger,fanger,storforbruger,højdespringer,hunger,bedrager,solfanger,flypassager,skomager,tronfølger,kofanger,brobygger,korsanger,nybygger,popsanger,lillefinger,anhænger,uromager,verdensborger,jager,afviger,byplanlægger,tilrettelægger,stemmesluger,kirkesanger,opdager,medpassager,filmmager,ørehænger,aflægger,undersøger,plattenslager,kupmager,projektmager,rocksanger,spækhugger,storryger,teatergænger,forsikringstager,slager,skibsbygger,æresborger,dobbeltgænger,livsledsager,slutbruger,hamburger,optager,bistandsmodtager,midtervælger,bådebygger,stenhugger,koncertgænger,visesanger,sprogbruger,rorgænger,udspringer,spasmager,sjælesørger,nejsiger,fastligger,pottemager,unionsborger,værktøjsmager,skovhugger,ikkeryger,bedsteborger,medaljetager,sofavælger,opdrager,trykkoger,sovjetborger,småborger,landbruger,smiger,søvngænger,alkoholmisbruger,enegænger,telefonsælger,skørtejæger,luxembourger,hvalfanger,hattemager,fupmager,koger,autografjæger,førstegangsvælger,koldkriger,jetjager,dambruger,brunsviger,folkesanger,længdespringer,slamsuger,stangspringer,drøvtygger,piberyger,svinger,mirakelmager,jogger,åger,rottefænger,pilfinger,drager,lykkejæger,kammersanger,eneforsørger,protestsanger,ødelægger,ringfinger,klamphugger,brolægger,pelsjæger,bondeanger,værnemager,videobåndoptager,slesviger,jordbruger,cliffhanger,fidusmager,cheeseburger,violinbygger,jasiger,langfinger,glasmager,superbruger,blodsuger,kassettebåndoptager,karetmager,buntmager,swinger,dukkemager,minestryger,grænsegænger,pristager,selvbygger,sejlmager,bondefanger,bassanger,orgelbygger,pølsemager,fuldrigger,ganger,overvåger,programlægger,støvdrager,personsøger,hovedjæger,mager,landligger,gårdsanger,spidsborger,autoophugger,handskemager,spilopmager,cykelanhænger,landssviger,agerbruger,minelægger,trespringer,nordslesviger,trampolinspringer,sjagger,indtrænger,minesøger,vindueskigger,tidtager,strømsluger,instrumentmager,møllebygger,kapgænger,radiomodtager,landstryger,nedstryger,socialbedrager,dørsælger,udspørger,suger,sandsiger,forespørger,badutspringer,myresluger,strandjæger,rørlægger,kæderyger,videooptager,stavgænger,vinsmager,riskoger,præmietager,løvsanger,fuglefænger,totenschlæger,tilbudsjæger,rebslager,oldenborger,sælfanger,kurvemager,parykmager,forlænger,skallesluger,medbygger,gransanger,våbendrager,festryger,pengepuger,lediggænger,fumlegænger,rørsanger,familieforsørger,ildsluger,fluefanger,amager,fremmedkriger,førstevælger,blandingsmisbruger,fedtfinger,guldmager,ophugger,blindgænger,sværddrager,sandsuger,brændehugger,intrigemager,diskussionsdeltager,udlægger,rigger,ildrager,marginalvælger,brandbæger,frederiksberger,pranger,faldskærmsjæger,inrigger,træskomager,stødfanger,bøssemager,tågænger,maskinbygger,frederiksborger,forsager,sabelsluger,kanalvælger,udligger,æggekoger,pølsefinger,diskenspringer,vager,karolinger,minnesanger,æglægger,børnemisbruger,versemager,besøger,refrænsanger,havesanger,mikrobrygger,overbringer,outrigger,tornsanger,roeoptager,elkoger,sniger,boligtager,stolemager,profitjæger,bogtilrettelægger,dyrplager,kartoffeloptager,dråbefanger,indsiger,hjulmager,humbugmager,kærsanger,tværdrager,visemager,skriger,omgænger,teltligger,gærdesanger,kabaretsanger,kabellægger,partigænger,udsuger,pasgænger,andenvælger,skovsanger,hindebæger,pindehugger,selvplager,saddelmager,dyndspringer,dypkoger,operettesanger,sålegænger,græshoppesanger,vitsmager,mineudlægger,forligger,klynger,passivryger,paradoksmager,videoblogger,spektakelmager,keyaccountmanager,lånsøger,paukeslager,nålebæger,merovinger,puger,landsplanlægger,panikmager,varetager,komplotmager,jigger,betonmager,kartager,lemviger,lykkebringer,havebruger,plager,vlogger,udrigger,tandbæger,logger,pligthugger,glarmager,røger,lugger,vrager,blærebæger,posekigger,spiger,sengeforligger,hirschfænger,skjolddrager,styltegænger,EU-borger,sivsanger,kartoffellægger,tweenager,frasemager,kongetiger,floskelmager,OL-deltager,ransager,vindmager,bilægger,friturekoger,underligger	lager,bæger,askebæger,fjernlager,æggebæger,raflebæger,målebæger,pilekogger,kogger,frilager,spiger
3	kab	202	0.00129	60	142	videnskab,egenskab,ondskab,lidenskab,naturvidenskab,statskundskab,kundskab,utroskab,galskab,kogalskab,vildskab,morskab,lægevidenskab,samfundsvidenskab,troskab,dovenskab,bagklogskab,sagkundskab,klogskab,kristendomskundskab,dårskab,medievidenskab,musikvidenskab,råddenskab,sundhedsvidenskab,sprogvidenskab,fuldskab,fagkundskab,arrigskab,filmvidenskab,retsvidenskab,oldtidskundskab,djævelskab,socialvidenskab,forkundskab,hedenskab,statsvidenskab,karakteregenskab,hundegalskab,drukkenskab,pseudovidenskab,humanvidenskab,folkesundhedsvidenskab,populærvidenskab,samfundskundskab,grundvidenskab,biovidenskab,mediekundskab,filmkundskab,geovidenskab,varekundskab,kælenskab,familiekundskab,erfaringsvidenskab,uklogskab,forklogskab,handelsvidenskab,køreegenskab,bullenskab,metavidenskab	selskab,regnskab,fællesskab,budskab,ægteskab,kendskab,landskab,mesterskab,mandskab,redskab,medlemskab,forsikringsselskab,skab,venskab,datterselskab,flyselskab,forfatterskab,køleskab,bekendtskab,statsborgerskab,formandskab,beredskab,partnerskab,pladeselskab,årsregnskab,ejerskab,lederskab,verdensmesterskab,broderskab,repræsentantskab,aktieselskab,boligselskab,borgerskab,moderselskab,filmselskab,fangenskab,bofællesskab,følgeskab,holdingselskab,rigsfællesskab,værtskab,pengeskab,telefonselskab,tvangsægteskab,slægtskab,anpartsselskab,kammeratskab,naboskab,nødberedskab,efterladenskab,fjendskab,andelsselskab,klædeskab,alarmberedskab,moderskab,præsteskab,medborgerskab,makkerskab,leasingselskab,kontorlandskab,svangerskab,købmandskab,medejerskab,faderskab,søsterselskab,herskab,ordførerskab,kommanditselskab,forældreskab,skæbnefællesskab,medielandskab,kompagniskab,vagtselskab,garderobeskab,skuffeselskab,bjerglandskab,grevskab,ukendskab,fornuftsægteskab,præsidentskab,uvenskab,interessentskab,djævelskab,kriseberedskab,koncernregnskab,familieskab,hedenskab,fryseskab,fadderskab,katastrofeberedskab,månelandskab,kosteskab,barskab,teselskab,overskab,gesandtskab,formuefællesskab,småborgerskab,kystlandskab,skriveredskab,driftsregnskab,proformaægteskab,fiskeredskab,førerskab,underskab,bogskab,formynderskab,sømandskab,stinkskab,hjørneskab,krydsejerskab,landmandskab,børneægteskab,livegenskab,adelskab,søsterskab,tjenerskab,medarbejderskab,ridderskab,pyramideselskab,glædesbudskab,boligfællesskab,isskab,vægskab,skydeselskab,torturredskab,kommandantskab,linnedskab,næstformandskab,svaleskab,gæstevenskab,vornedskab,sponsorskab,fostbroderskab,jalousiskab,vaneægteskab,sejrsbudskab,dæksmandskab,regentskab,landsmandskab,skibsmandskab,svogerskab
3	ted	61	0.00115	1	60	ørsted	sted,værksted,spillested,mødested,hjemsted,spisested,værested,gerningssted,opholdssted,ståsted,fristed,valgsted,bosted,gravsted,samlingssted,stoppested,tilholdssted,ulykkessted,landsted,busstoppested,levested,husmandssted,autoværksted,arnested,websted,fødested,skjulested,ildsted,bæltested,vadested,gemmested,tilflugtssted,åsted,hvilested,brandsted,udsted,netsted,traktørsted,tingsted,skriftsted,tjenestested,kursted,voksested,findested,skriveværksted,voldsted,fundsted,malerværksted,ynglested,insted,rettersted,toldsted,rastested,chatsted,tappested,trykkested,postindleveringssted,dødssted,fyrsted,postafhentningssted
3	tet	353	0.00111	345	8	kvalitet,aktivitet,realitet,kriminalitet,identitet,kapacitet,stabilitet,autoritet,kreativitet,solidaritet,facilitet,effektivitet,popularitet,minoritet,fleksibilitet,seksualitet,produktivitet,graviditet,livskvalitet,kvartet,prioritet,intensitet,suverænitet,nationalitet,elektricitet,loyalitet,likviditet,nervøsitet,mentalitet,lokalitet,specialitet,integritet,mobilitet,legitimitet,kompleksitet,homoseksualitet,kontinuitet,brutalitet,modernitet,anonymitet,passivitet,majoritet,naivitet,originalitet,pubertet,antikvitet,ustabilitet,etnicitet,strygekvartet,autenticitet,intimitet,neutralitet,musikalitet,biodiversitet,immunitet,religiøsitet,diversitet,kvintet,formalitet,banalitet,rationalitet,seriøsitet,førsteprioritet,aggressivitet,normalitet,overkapacitet,absurditet,kvantitet,anciennitet,aktualitet,funktionalitet,sentimentalitet,vitalitet,soliditet,aktiemajoritet,bandekriminalitet,maskulinitet,objektivitet,individualitet,generøsitet,topprioritet,spiritualitet,genialitet,ungdomskriminalitet,spontanitet,habilitet,fertilitet,radioaktivitet,virtuositet,inhabilitet,lydkvalitet,rentabilitet,vandkvalitet,trivialitet,eksklusivitet,ineffektivitet,mortalitet,sensibilitet,sensualitet,invaliditet,sekstet,kuriositet,notabilitet,raritet,sanitet,inaktivitet,konformitet,elasticitet,subjektivitet,validitet,illoyalitet,sensitivitet,teknikalitet,radikalitet,humanitet,proportionalitet,negativitet,småkriminalitet,homogenitet,vulgaritet,motet,celebritet,æstet,irrationalitet,stupiditet,positivitet,perversitet,morbiditet,krævementalitet,kausalitet,varietet,hyperaktivitet,virilitet,monumentalitet,bonitet,specificitet,universalitet,regularitet,totalitet,impulsivitet,septet,oktet,plasticitet,deformitet,moralitet,eventualitet,animositet,ekstremitet,relativitet,flokmentalitet,sterilitet,promiskuitet,irritabilitet,senilitet,perfiditet,primitivitet,urbanitet,tonalitet,socialitet,frivolitet,abnormitet,affinitet,densitet,polaritet,jovialitet,entitet,excentricitet,biseksualitet,repræsentativitet,kalamitet,heteroseksualitet,intentionalitet,legalitet,melodiøsitet,singularitet,komplementaritet,obskønitet,parallelitet,idealitet,kræmmermentalitet,bestialitet,refleksivitet,subtilitet,dualitet,progressivitet,kollektivitet,viskositet,destruktivitet,kollegialitet,respektabilitet,paritet,nullitet,pietet,transseksualitet,andenprioritet,modalitet,simplicitet,intertekstualitet,pompøsitet,heterogenitet,diskontinuitet,kompatibilitet,intellektualitet,porøsitet,uniformitet,liberalitet,pluralitet,illegalitet,massivitet,historicitet,fatalitet,variabilitet,servilitet,mondænitet,rivalitet,anormalitet,egalitet,grandiositet,underekstremitet,egocentricitet,labilitet,unormalitet,reciprocitet,toksicitet,frigiditet,atonalitet,potentialitet,hypermobilitet,spasticitet,emotionalitet,præpubertet,nobilitet,selektivitet,inhumanitet,overekstremitet,linearitet,immobilitet,infantilitet,familiaritet,bipolaritet,plausibilitet,illikviditet,irregularitet,paternitet,publicitet,flokimmunitet,irreversibilitet,præsenilitet,konvertibilitet,infleksibilitet,asocialitet,immoralitet,hadkriminalitet,vivacitet,frontalitet,konstruktivitet,grammatikalitet,inferioritet,inhomogenitet,konkavitet,durabilitet,monstrøsitet,sekularitet,kavitet,hydroelektricitet,konneksitet,perfektibilitet,distinktivitet,femininitet,paradoksalitet,restriktivitet,inkompatibilitet,duktilitet,konicitet,illegitimitet,differentiabilitet,todimensionalitet,umoralitet,kongenialitet,futilitet,provinsialitet,festivitet,multimodalitet,puerilitet,dobbeltkvartet,debilitet,opacitet,offensivitet,gravitet,ambiguitet,tredimensionalitet,perpleksitet,simultanitet,preciøsitet,reversibilitet,fotoelektricitet,fraternitet,termoelektricitet,fragilitet,imbecilitet,permissivitet,grådlabilitet,natalitet,eksterritorialitet,klassicitet,agilitet,maternitet,konveksitet,kordialitet,umusikalitet,græcitet,nasalitet,pseudonymitet,etnocentricitet,fidelitet,depressivitet,præmaturitet,kommensurabilitet,sonoritet,suggestibilitet,assertivitet,endimensionalitet,rigiditet,kapillaritet,vejstabilitet,cirkularitet,latinitet,periodicitet,profitabilitet,nativitet,lascivitet,opportunitet,immortalitet,frugalitet,patogenitet,flerdimensionalitet,receptivitet,professionalitet,irreligiøsitet,intensivitet,suggestivitet,konduktivitet,kapabilitet,rapiditet,heteronormativitet	universitet,fakultet,folkeuniversitet,societet,admiralitet,epitet,kommunitet,intet
3	sse	216	0.00110	216	0	masse,interesse,klasse,presse,kasse,adresse,prinsesse,messe,skilsmisse,sparekasse,kulisse,statskasse,terrasse,bøsse,pensionskasse,middelklasse,nisse,postkasse,kronprinsesse,pengekasse,verdensklasse,børnehaveklasse,overklasse,gearkasse,arbejderklasse,tresse,dagspresse,finesse,brevkasse,biomasse,særklasse,delikatesse,trusse,papkasse,stewardesse,bogmesse,stærekasse,underklasse,værktøjskasse,bisse,prisklasse,brystkasse,baronesse,vandmasse,grimasse,arvemasse,basse,verdenspresse,topklasse,vægtklasse,flyttekasse,tosse,talentmasse,højmesse,sandkasse,esse,isse,mellemklasse,tagterrasse,kusse,tristesse,boligmasse,egeninteresse,sygekasse,fisse,nosse,akkuratesse,landsbytosse,almisse,madkasse,muskelmasse,gymnasieklasse,postadresse,altankasse,rugekasse,mousse,cigarkasse,raslebøsse,mesterklasse,redekasse,julenisse,fælleskasse,petitesse,dysse,trisse,komtesse,modtageklasse,fuglekasse,havenisse,vildbasse,parallelklasse,sparebøsse,seddelpresse,chokolademousse,spradebasse,internetadresse,fugemasse,kokasse,kyndelmisse,stendysse,citronmelisse,ugepresse,lirekasse,dødsmesse,kravlenisse,sprosse,trykpresse,slangebøsse,turistklasse,afgangsklasse,havgasse,rodekasse,hjemmeadresse,bulderbasse,trosse,abbedisse,høkasse,drillenisse,mælkekasse,lyskasse,papirmasse,brobisse,sænkekasse,vatnisse,sætternisse,kirkebøsse,kermesse,langdysse,boulevardpresse,brokkasse,ordklasse,spartelmasse,bouillabaisse,visse,diakonisse,brumbasse,noblesse,melasse,officersmesse,karusse,førstehjælpskasse,rotationspresse,lånekasse,luftbøsse,haglbøsse,togstewardesse,karosse,potemkinkulisse,sensationspresse,mejsekasse,kukkasse,centerklasse,træmasse,saltbøsse,lønklasse,sættekasse,skarnbasse,hønisse,sufflørkasse,duchesse,læseklasse,almeninteresse,hjælpeklasse,modtagelsesklasse,runddysse,vinduessprosse,hausse,glemmekasse,peberbøsse,remisse,isskosse,barkasse,skatteklasse,populærpresse,sjælemesse,smadderkasse,atommasse,maitresse,vinpresse,glimmerbøsse,desinteresse,guldbasse,vandreklasse,forbindskasse,skærekasse,tangatrusse,hjemklasse,garntrisse,skosse,kædekasse,melisse,pakkasse,karkasse,skramlekasse,guldtresse,kærmysse,halmpresse,glosse,baisse,disse,recepisse,salonbøsse,mantisse,a-kasse,thaitrusse,skrumlekasse,obsklasse,klemkasse,e-postadresse,fromesse,IP-adresse,e-mailadresse,abscisse,ballepresse,vidisse,rumlekasse	
3	åde	48	0.00110	24	24	måde,flåde,fremgangsmåde,gåde,nåde,talemåde,handlemåde,stavemåde,unåde,våde,væremåde,tænkemåde,tømmerflåde,handelsflåde,levemåde,fråde,skrivemåde,udtryksmåde,malemåde,synsmåde,fiskeflåde,bydemåde,navnemåde,tillægsmåde	område,lokalområde,hovedstadsområde,forretningsområde,landområde,sundhedsområde,naturområde,nærområde,yderområde,byområde,indsatsområde,vådområde,fokusområde,kystområde,randområde,stofområde,sprogområde,delområde,legeområde,byudviklingsområde,virkeområde,udeområde,takstområde,sagområde
3	lik	40	0.00105	17	23	replik,republik,slik,katolik,symbolik,forbundsrepublik,folkerepublik,bananrepublik,hydraulik,kolik,slutreplik,lollik,flik,duplik,åbningsreplik,angelik,rallik	øjeblik,blik,overblik,henblik,indblik,slik,klik,tilbageblik,udblik,sideblik,falkeblik,havblik,røntgenblik,dræberblik,bølgeblik,højreklik,kenderblik,slutblik,venstreklik,hvidblik,bland selv-slik,argusblik,dobbeltklik
3	ske	149	0.00105	121	28	sygeplejerske,flaske,svenske,taske,påske,væske,maske,æske,handske,aske,sundhedsplejerske,håndtaske,støbeske,syerske,lyske,sveske,skoletaske,hjemmesygeplejerske,netmaske,oversygeplejerske,afdelingssygeplejerske,teske,fløjlshandske,gasmaske,gasflaske,sutteflaske,husholderske,vinflaske,havtaske,groteske,boksehandske,skuldertaske,samleverske,ansigtsmaske,sølvske,tændstikæske,hulske,sodavandsflaske,freske,grydeske,iltmaske,dametaske,køletaske,toilettaske,sprinklervæske,spiseske,sjuske,lædertaske,dødsmaske,tændvæske,flyveaske,kølervæske,operationssygeplejerske,bremsevæske,halvflaske,returflaske,sandsigerske,murske,dykkermaske,helflaske,væverske,ledsagerske,magnumflaske,pilleæske,attachétaske,plejerske,termoflaske,halvmaske,humoreske,fremkaldervæske,morderske,støvmaske,rytterske,potaske,engangshandske,weekendtaske,burleske,skindhandske,påklæderske,feltflaske,skolesundhedsplejerske,kassererske,pusletaske,syæske,dessertske,eventyrerske,sladdertaske,indehaverske,sigøjnerske,rendemaske,klukflaske,hyrdetaske,saddeltaske,tiggerske,måleske,rufferske,trøske,potageske,smageske,kogerske,fugeske,pølsetaske,vrangmaske,fortyndervæske,glacéhandske,barneske,naboerske,halvliterflaske,retmaske,fægtemaske,visittaske,helliterflaske,halvandenliterflaske,laske,kætterske,enliterflaske,stridshandske,grødske,bordeauxvæske,skummeske,vogterske	menneske,ønske,medmenneske,magtmenneske,overmenneske,bymenneske,undermenneske,kvindemenneske,ordensmenneske,friluftsmenneske,fortidsmenneske,urmenneske,privatmenneske,slangemenneske,umenneske,vanemenneske,gennemsnitsmenneske,selskabsmenneske,abemenneske,morgenmenneske,hjemmemenneske,hulemenneske,utyske,pligtmenneske,neandertalmenneske,B-menneske,forstandsmenneske,A-menneske
3	ale	121	0.00102	90	31	aftale,tale,samtale,finale,skandale,semifinale,omtale,kvartfinale,hale,tiltale,fredsaftale,udtale,telefonsamtale,nytårstale,pokalfinale,fortale,ottendedelsfinale,biennale,svale,jobsamtale,kabale,påtale,rammeaftale,dvale,takketale,købsaftale,hestehale,presseomtale,skåltale,festtale,båltale,eksklusivaftale,særaftale,ansættelsessamtale,foromtale,parallelaftale,låneaftale,brandtale,enetale,licensaftale,rundbordssamtale,saltomortale,salgstale,grænseaftale,hyldesttale,dundertale,medarbejdersamtale,hovedaftale,tungetale,rottehale,underhåndsaftale,forældresamtale,pastorale,triennale,oksehale,silkehale,tryghedsaftale,rævehale,landsvale,jomfrutale,trontale,tekstudtale,tordentale,svalehale,portrætsamtale,slørhale,digesvale,ikkespredningsaftale,dolkhale,gentlemanaftale,kattehale,timbale,stormsvale,sekstendedelsfinale,hadtale,syvkabale,bysvale,kollektivaftale,tågetale,teknologiaftale,stumphale,barteraftale,femme fatale,skole-hjem-samtale,trelandeaftale,VM-finale,væselhale,musehale,snohale,lyrehale	materiale,personale,lokale,potentiale,speciale,klasselokale,byggemateriale,bevismateriale,baglokale,øvelokale,kabinepersonale,rationale,råmateriale,selskabslokale,rengøringspersonale,pressemateriale,festlokale,kontorpersonale,fælleslokale,differentiale,letvægtsmateriale,gratiale,frontpersonale,teorilokale,fundmateriale,lærerpersonale,regale,graduale,numerale,klapmateriale,AV-materiale
3	arn	80	0.00101	0	80		barn,barnebarn,småbarn,garn,spædbarn,bysbarn,enebarn,hjertebarn,oldebarn,vidunderbarn,problembarn,pigebarn,legebarn,skarn,smertensbarn,adoptivbarn,skilsmissebarn,ønskebarn,fødselsdagsbarn,plejebarn,menneskebarn,skolebarn,stedbarn,hittebarn,særbarn,sejlgarn,bomuldsgarn,feriebarn,tipoldebarn,bundgarn,bonusbarn,reagensglasbarn,fiskegarn,uldgarn,pattebarn,gudbarn,gadebarn,bybarn,dukkebarn,fællesbarn,papbarn,delebarn,mongolbarn,sognebarn,søndagsbarn,strikkegarn,drivgarn,hørgarn,troldebarn,brystbarn,kamgarn,amagergarn,flaskebarn,bindegarn,kælebarn,gudebarn,regnbuebarn,førskolebarn,ørebarn,perlegarn,nøglebarn,vævegarn,flyndergarn,elleveårsbarn,damp-barn,stoppegarn,ægtebarn,toårsbarn,skødebarn,søskendebarn,knyttegarn,DAMP-barn,diebarn,gammelmandsbarn,næstsøskendebarn,tvindegarn,svøbelsebarn,niårsbarn,toggergarn,filamentgarn
3	lem	26	0.00100	6	20	kattelem,slem,faldlem,storeslem,metusalem,lilleslem	problem,medlem,folketingsmedlem,æresmedlem,klem,partimedlem,hovedproblem,kongresmedlem,forklaringsproblem,emblem,rådsmedlem,søvnproblem,landsstyremedlem,fattiglem,klanmedlem,komitémedlem,forlem,pseudoproblem,baglem,skinproblem
3	den	78	0.00095	75	3	verden,viden,orden,dagsorden,omverden,fanden,størrelsesorden,optræden,tilbagevenden,færden,verdensorden,underverden,uorden,medieverden,torden,bankverden,forretningsorden,samfundsorden,tilbagetræden,finansverden,paratviden,ikrafttræden,specialviden,vorden,gæsteoptræden,gylden,retsorden,baggrundsviden,drømmeverden,tiltræden,rangorden,begrebsverden,indtræden,gadeuorden,tankeverden,hakkeorden,fratræden,fremtræden,bedreviden,voksenverden,frimurerorden,teatertorden,basisviden,udtræden,husorden,forhåndsviden,almenviden,skoleverden,grundviden,åndeverden,lilleverden,tredjeverden,afværgedagsorden,olden,jesuiterorden,førstehåndsviden,medviden,nummerorden,haltefanden,efterverden,slagorden,skinverden,yderverden,indskriden,franciskanerorden,solooptræden,cistercienserorden,stillesidden,genindtræden,loden,allroundviden,andenhåndsviden,bogstavorden,underhåndsviden,elementærviden	eden,syden,norden
3	del	214	0.00092	170	44	fordel,model,halvdel,handel,andel,tredjedel,bydel,fjerdedel,seddel,svindel,boghandel,detailhandel,landsdel,femtedel,rollemodel,mandel,nederdel,stemmeseddel,ejendel,fyreseddel,brøkdel,reservedel,adel,samhandel,størstedel,bøddel,verdensdel,bagdel,saddel,ønskeseddel,tiendedel,procentdel,menneskehandel,kedel,bestanddel,topmodel,pengeseddel,frihandel,fotomodel,pendel,pedel,lønseddel,grænsehandel,supermodel,løbeseddel,valgsvindel,vinhandel,studehandel,udenrigshandel,kønsdel,vandel,kunsthandel,runddel,skattefordel,byttehandel,insiderhandel,slavehandel,nudel,legemsdel,landhandel,sjettedel,lavendel,daddel,slutseddel,tøddel,tømmerhandel,internethandel,hundrededel,lodseddel,vragdel,puddel,nøgenmodel,overdel,heksekedel,huskeseddel,fiskehandel,forsikringssvindel,grønthandel,dyrehandel,trælasthandel,farvehandel,indlægsseddel,blomsterhandel,elkedel,ottendedel,tusindkroneseddel,tusindedel,hundredkroneseddel,sortbørshandel,milliontedel,løsdel,købmandshandel,spiseseddel,underdel,syvendedel,antikvarboghandel,gruekedel,butikshandel,smørrebrødsseddel,dosmerseddel,tyvendedel,tuskhandel,dadel,højadel,spindel,fyringsseddel,rondel,lavadel,aktantmodel,produkthandel,bittermandel,rudel,følgeseddel,vatrondel,kolonialhandel,sardel,saltmandel,strakshandel,passerseddel,tilgodeseddel,mærkeseddel,milliardtedel,tolvtedel,niendedel,kobberkedel,femhundredekroneseddel,transithandel,materialhandel,pundseddel,retshandel,fløjtekedel,buksenederdel,sekstendedel,halvtredskroneseddel,paddel,vildthandel,silkepuddel,billiontedel,viktualiehandel,niogtyvendedel,krakmandel,seksogtyvendedel,attendedel,toogtyvendedel,nittendedel,ellevtedel,fireogtyvendedel,enogtyvendedel,femtendedel,otteogtyvendedel,kordel,glandel,tredivtedel,syvogtyvendedel,slå om-nederdel,indenrigshandel,syttendedel,strøghandel,padel,spothandel,fjortendedel,øksnehandel,femogtyvendedel,donkeykedel,mortadel,treogtyvendedel,trettendedel,en gros-handel,bryggekedel,e-handel	middel,lægemiddel,virkemiddel,hjælpemiddel,transportmiddel,bordel,sprøjtemiddel,rusmiddel,levnedsmiddel,magtmiddel,betalingsmiddel,vaskemiddel,kommunikationsmiddel,produktionsmiddel,sødemiddel,læremiddel,bindemiddel,vidundermiddel,drivmiddel,slankemiddel,sovemiddel,citadel,blegemiddel,fødemiddel,skyllemiddel,befordringsmiddel,smøremiddel,næringsmiddel,universalmiddel,rensemiddel,træbeskyttelsesmiddel,bændel,værnemiddel,brækmiddel,slibemiddel,hævemiddel,meddelelsesmiddel,afspændingsmiddel,pletfjerningsmiddel,konsistensmiddel,stråforkortelsesmiddel,disciplinarmiddel,flusmiddel,hærdemiddel
3	tik	221	0.00088	195	26	politik,butik,kritik,statistik,stik,matematik,journalistik,udenrigspolitik,etik,taktik,gymnastik,problematik,dramatik,atletik,praktik,æstetik,romantik,optik,finanspolitik,mystik,sikkerhedspolitik,logistik,karakteristik,antik,kulturpolitik,automatik,erotik,plastik,energipolitik,socialpolitik,genbrugsbutik,akustik,flygtningepolitik,klimapolitik,elastik,tøjbutik,landbrugspolitik,dagligvarebutik,retspolitik,grammatik,integrationspolitik,netbutik,tændstik,kommunalpolitik,lokalpolitik,kosmetik,genetik,personalepolitik,blokpolitik,gårdbutik,selvkritik,købmandsbutik,værdipolitik,diagnostik,tematik,discountbutik,skolepolitik,systematik,partipolitik,storpolitik,realpolitik,ældrepolitik,landspolitik,akrobatik,rygepolitik,symbolpolitik,handelspolitik,gestik,trafikpolitik,poetik,rodebutik,alkoholpolitik,seniorpolitik,lingvistik,informatik,didaktik,dogmatik,slagterbutik,erhvervspraktik,nærbutik,kildekritik,ornamentik,dialektik,sprogpolitik,detailbutik,svovlstik,presseetik,semiotik,kulturkritik,skruestik,lønpolitik,nationalromantik,efterkritik,verdenspolitik,kædebutik,gotik,trommestik,fødevarebutik,bioetik,identitetspolitik,sportsjournalistik,semantik,kiropraktik,kunstkritik,springgymnastik,geopolitik,regionalpolitik,kostpolitik,fantastik,essayistik,ledighedsstatistik,indkomstpolitik,etbarnspolitik,onlinebutik,fonetik,bagbutik,pragmatik,ideologikritik,hermeneutik,senromantik,telebutik,batik,skolastik,redskabsgymnastik,aritmetik,stilistik,sociolingvistik,inddæmningspolitik,statik,tandstik,folkloristik,juvelerbutik,fiberoptik,kybernetik,pneumatik,fagpolitik,midterpolitik,visnepolitik,datalingvistik,nyromantik,voldsromantik,hektik,nykritik,ørestik,højromantik,peristaltik,isolationspolitik,germanistik,enkeltsagspolitik,petitjournalistik,numismatik,forpraktik,psykosomatik,telematik,somatik,tekstkritik,revolverjournalistik,hermetik,datamatik,kriminalistik,protetik,kinetik,novellistik,slavistik,diætetik,kromatik,ballistik,fuldautomatik,diplomatik,psykolingvistik,homiletik,antiseptik,skrækromantik,emblematik,aseptik,gonzojournalistik,floristik,elektrostatik,galvanoplastik,korridorpolitik,astronautik,gravstik,paraatletik,propædeutik,agrarpolitik,transformationsgrammatik,energetik,heuristik,terapeutik,hydrostatik,anglistik,cytogenetik,romanistik,domestik,rideelastik	stik,bestik,spadestik,knivstik,kobberstik,trumfstik,solstik,nålestik,myggestik,indstik,overstik,bistik,sidestik,spisebestik,stålstik,halvstik,hunstik,bananstik,jackstik,hanstik,loppestik,tegnebestik,scartstik,USB-stik,understik,fordelerstik
3	ist	407	0.00087	402	5	journalist,turist,list,bilist,pensionist,komponist,terrorist,jurist,cyklist,pianist,nazist,kommunist,frist,aktivist,solist,specialist,guitarist,islamist,kvist,socialist,organist,bassist,gnist,kursist,optimist,feminist,ekstremist,artist,violinist,førtidspensionist,nationalist,fundamentalist,tidsfrist,racist,pist,humanist,saxofonist,ateist,trompetist,finalist,lobbyist,tvist,folkepensionist,motorcyklist,idealist,statist,spritbilist,separatist,grossist,individualist,motionist,cellist,fascist,rist,brist,campist,tenorsaxofonist,kapitalist,nynazist,liberalist,sportsjournalist,buddhist,stylist,receptionist,anarkist,marxist,realist,pessimist,evangelist,twist,populist,autist,basunist,højreekstremist,modernist,vokalist,dokumentarist,klarinettist,prokurist,perfektionist,egoist,maoist,fløjtenist,humorist,spøgelsesbilist,impressionist,unionist,flugtbilist,moralist,folkesocialist,zionist,freelancejournalist,opportunist,surrealist,traditionalist,altsaxofonist,mejerist,instrumentalist,baptist,pacifist,materialist,invalidepensionist,kolonist,generalist,cirkusartist,semifinalist,alkymist,essayist,reformist,lingvist,marineinfanterist,kolorist,prosaist,gratist,royalist,civilist,kommanditist,stalinist,bratschist,antikrist,ekspressionist,mandschauvinist,sadist,højrepopulist,protagonist,imperialist,oboist,kopist,telegrafist,naivist,publicist,nationalsocialist,whist,præmiewhist,vrist,domorganist,propagandist,stilist,satanist,masochist,avantgardist,filatelist,radiojournalist,gaullist,narcissist,kontorist,symbolist,trotskist,ekvilibrist,cembalist,naturist,illusionist,futurist,rationalist,vibrafonist,harpenist,internationalist,rødgardist,kautionist,livrist,hornist,postmodernist,revisionist,librettist,nyfascist,nihilist,utopist,kreationist,infanterist,kollektivist,reservist,modist,orientalist,percussionist,monarkist,bandagist,højrenationalist,naturalist,adventist,nudist,eksistentialist,karakterbrist,kommunikationsbrist,gardist,dadaist,sopransaxofonist,darwinist,leninist,falangist,grillrist,metodist,jubeloptimist,hedonist,fetichist,antagonist,minimalist,kvindelist,klokkenist,nist,venstreekstremist,ekshibitionist,ankefrist,chauvinist,funktionalist,pladderhumanist,mytterist,konstruktivist,barytonsaxofonist,kolonialist,positivist,sofist,blist,artillerist,maskinist,seminarist,leadguitarist,calvinist,spiritist,telefonist,pietist,privatist,kolumnist,industrialist,ørentvist,relativist,sexist,kubist,fagottist,korist,betonkommunist,elitebilist,isolationist,monopolist,klassicist,tubaist,kornettist,socialrealist,fatalist,folklorist,germanist,novellist,hinduist,strukturalist,sadomasochist,alpinist,okkultist,onanist,evolutionist,syndikalist,militarist,absurdist,formalist,eskapist,nyrealist,bigamist,encyklopædist,optometrist,altruist,føderalist,nyliberalist,socialkonstruktivist,detaillist,alkoholist,salmist,fauvist,parodist,trombonist,slavist,morfinist,parcellist,protektionist,romanist,vitalist,syvendedagsadventist,kabbalist,havarist,monetarist,buffist,determinist,defaitist,sociolingvist,reduktionist,loyalist,alderspensionist,zenbuddhist,fløjtist,papist,krigslist,konkretist,paukist,florist,rygsæksturist,utilitarist,billedjournalist,ulykkesbilist,violoncellist,multikulturalist,sensualist,søndagsbilist,nymarxist,antimilitarist,purist,recidivist,torbist,økoturist,nyklassicist,behaviorist,galgenfrist,færist,lutenist,absolutist,skandinavist,dualist,datalingvist,ortopædist,kommunitarist,valdhornist,monist,kavalerist,dokumentalist,selvpensionist,neutralist,universalist,koncipist,gonzojournalist,judaist,pluralist,hellenist,radikalist,panelist,akvarist,petitjournalist,manicurist,obskurantist,kancellist,batist,skraberist,græcist,lamaist,vivisektionist,pointillist,konformist,delirist,psykolingvist,machiavellist,talmudist,primitivist,eksorcist,socialliberalist,revanchist,monoteist,historist,rigorist,latinist,polygamist,regionalist,versionist,harpist,partikularist,tachist,polyteist,somnambulist,thomist,podagrist,trappist,haussist,xylofonist,daoist,tegningsfrist,tenorist,nominalist,rabulist,hellebardist,deist,iranist,salafist,panteist,pamfletist,anglist,ventrilokvist,esperantist,indeterminist,senmodernist,drogist,assist,professionalist,firemandswhist,teist,excerpist,spiritualist,verist,empirist,elitist,solipsist,jihadist,nordist,annalist,intellektualist,gambist,baissist,georgist,tremandswhist	tvist,brist,kommunikationsbrist,karakterbrist,batist
3	rug	53	0.00084	17	36	brug,misbrug,genbrug,sprogbrug,magtmisbrug,stofmisbrug,alkoholmisbrug,drug,narkotikamisbrug,våbenbrug,blandingsmisbrug,aftenbrug,børnemisbrug,vinterbrug,helårsbrug,designerdrug,epo-misbrug	brug,landbrug,forbrug,misbrug,genbrug,sprogbrug,privatforbrug,overforbrug,magtmisbrug,stofmisbrug,skovbrug,alkoholmisbrug,jordbrug,dambrug,ressourceforbrug,merforbrug,drug,trug,havbrug,havebrug,kvægbrug,agerbrug,narkotikamisbrug,familiebrug,storforbrug,fritidslandbrug,kollektivbrug,blandingsmisbrug,børnemisbrug,standbyforbrug,svedjebrug,designerdrug,egetforbrug,trevangsbrug,tovangsbrug,epo-misbrug
3	jde	81	0.00084	21	60	højde,øjenhøjde,fejde,børnehøjde,omgangshøjde,frihøjde,drøjde,knæhøjde,ståhøjde,faldhøjde,blodfejde,lofthøjde,slægtsfejde,middelhøjde,mandshøjde,middagshøjde,garderhøjde,stammefejde,solhøjde,pennefejde,opfindelseshøjde	arbejde,samarbejde,forarbejde,overarbejde,håndarbejde,vejarbejde,papirarbejde,hjælpearbejde,hjemmearbejde,børnearbejde,gruppearbejde,feltarbejde,lejde,benarbejde,tvangsarbejde,natarbejde,byggearbejde,detektivarbejde,deltidsarbejde,dobbeltarbejde,slavearbejde,merarbejde,fodarbejde,sorgarbejde,holdarbejde,sæsonarbejde,murerarbejde,udearbejde,kvalitetsarbejde,træskærerarbejde,sisyfosarbejde,rutinearbejde,pillearbejde,strafarbejde,emnearbejde,distancearbejde,akkordarbejde,skærmarbejde,pligtarbejde,hestearbejde,fjernarbejde,elevarbejde,måneskinsarbejde,knoklearbejde,korpusarbejde,malearbejde,muldvarpearbejde,dagarbejde,kropsarbejde,halvdagsarbejde,udendørsarbejde,heldagsarbejde,dagsarbejde,herkulesarbejde,nørklearbejde,fuskearbejde,polsterarbejde,korttidsarbejde,delarbejde,trællearbejde
3	ber	136	0.00081	129	7	september,november,december,oktober,køber,angriber,peber,serber,løber,taber,araber,feber,skaber,kaliber,fiber,skiløber,filmskaber,udløber,forløber,skyskraber,barber,indkøber,frontløber,rabarber,glasfiber,medløber,dræber,opkøber,modeskaber,selvmordsbomber,råber,friløber,høfeber,vinkelsliber,bundskraber,hurtigløber,kulfiber,døber,skøjteløber,skraber,saudiaraber,stræber,overløber,grænseoverløber,griber,kandestøber,mobber,skovløber,bomber,berber,sorber,hækkeløber,chilipeber,seksløber,rejsefeber,kandelaber,muskelfiber,kondiløber,skubber,kunstskøjteløber,nældefeber,denguefeber,bronzestøber,væddeløber,afskiber,slæber,lampefeber,opråber,skarlagensfeber,tilløber,svaber,sårfeber,ultraløber,styrtløber,sliber,skærsliber,barberskraber,sneskraber,bagstræber,udråber,isskraber,mikrofiber,gigtfeber,stafetløber,støber,koldfeber,rubber,piber,taburetklæber,polyesterfiber,bordløber,cementstøber,klokkestøber,engpiber,skovpiber,træløber,glassliber,kostfiber,emirataraber,kirtelfeber,kokosfiber,diamantsliber,mytedræber,sandløber,klimatfeber,plantefiber,excentersliber,tredagesfeber,grubber,youtuber,skriftstøber,dubber,trekantsliber,betelpeber,kærløber,lysestøber,skånejobber,deltasliber,jobber,kapløber,kalvekastningsfeber,kemofiber,plakatopklæber,rudeskraber,stylteløber,fleksjobber,efteraber,svingefeber,afskraber	peber,kaliber,kobber,cayennepeber,chilipeber,cinnober,vulkanfiber
3	ner	334	0.00079	332	2	kunstner,amerikaner,træner,partner,landstræner,københavner,designer,italiener,republikaner,samarbejdspartner,tjener,cheftræner,billedkunstner,container,tegner,japaner,albaner,indianer,iraner,afghaner,afrikaner,gartner,brasilianer,pioner,rumæner,fællesnævner,pakistaner,entertainer,sigøjner,odenseaner,ukrainer,argentiner,tibetaner,berliner,sydafrikaner,falkoner,cubaner,efterlønner,kanoner,låner,scanner,talebaner,retsmediciner,pilsner,meningsdanner,ener,tjetjener,mexicaner,tryllekunstner,koreaner,skyldner,øjenåbner,løgner,åbner,rabbiner,handelspartner,nordkoreaner,wiener,lommeregner,multikunstner,samtalepartner,sydkoreaner,nigerianer,marokkaner,bladtegner,runner,kenyaner,chilener,diner,slovener,anlægsgartner,overrabbiner,kørner,colombianer,chefdesigner,dansepartner,makedoner,væbner,forurener,kirketjener,filippiner,sydamerikaner,frederikshavner,puritaner,hjælpetræner,germaner,afroamerikaner,grundtvigianer,hævner,mediciner,jordaner,aboriginer,nævner,scenekunstner,tekstildesigner,crooner,latinamerikaner,veganer,fredericianer,taiwaner,holstener,opinionsdanner,kosovoalbaner,tuner,karikaturtegner,montenegriner,libertiner,amagerkaner,paramediciner,kammertjener,portner,venezuelaner,lutheraner,mohikaner,jamaicaner,åndemaner,haitianer,eyeliner,dalmatiner,mariner,nordafrikaner,randrusianer,dåseåbner,sicilianer,muhamedaner,zeppeliner,krydsfiner,londoner,døråbner,indvåner,selvbruner,sexpartner,liner,afsoner,stumtjener,toner,peruaner,stadsgartner,horsensianer,lystløgner,livskunstner,pantelåner,napolitaner,falskmøntner,bordskåner,turkmener,korsikaner,aserbajdsjaner,sparringpartner,tusindkunstner,trojaner,srilankaner,kæmner,bolivianer,planner,christianshavner,nordamerikaner,spartaner,hunner,athener,efterligner,kollegianer,venetianer,latiner,dominikaner,franciskaner,puertoricaner,finer,liberianer,sudaner,ivorianer,uruguayaner,camerouner,singaporeaner,anglikaner,arbejdsmediciner,stønner,strafafsoner,costaricaner,hellener,rotarianer,indlåner,pengeudlåner,florentiner,mayaindianer,tonekunstner,saracener,angolaner,døgner,korttegner,freudianer,værner,bahrainer,pletfjerner,helsingoraner,afrikaaner,forsoner,victorianer,soraner,inliner,nicaraguaner,bretoner,jakobiner,honduraner,herlovianer,liechtensteiner,muskedonner,ecuadorianer,glascontainer,falskner,fijianer,phoner,vegetarianer,kalkfjerner,ungtjener,danskamerikaner,skørlevner,sydsudaner,rigstræner,papuaner,handelsgartner,gråstener,bhutaner,hawaiianer,trapezkunstner,persianer,benediktiner,korsoraner,jungianer,panamaner,brevordner,omaner,kelner,idrætsmediciner,lugtfjerner,frakkeskåner,biomediciner,salvadoraner,øjentjener,modetegner,blomstergartner,burkiner,aleksandriner,flaskeåbner,rentegner,guatemalaner,burmaner,infektionsmediciner,andorraner,siouxindianer,pommeraner,kapselåbner,brugskunstner,brevåbner,trettener,sierraleoner,slagelseaner,tuvaluaner,samoaner,lørner,kretiner,lakfjerner,tonganer,botswaner,guineaner,augustiner,løgstørianer,gravenstener,birgittiner,generalnævner,castilianer,neuruppiner,vestsamoaner,ækvatorialguineaner,mr-scanner,cargoliner,levantiner,OCR-scanner,regensianer,malingfjerner,fjortener,harpuner,MR-scanner,CT-scanner,sortekunstner,beregner,klanner,ringordner,guyaner,selvskyldner,sandvåner,mallorcaner,lansener,cambodianer,hercegoviner,nittener,aarhusianer,apacheindianer,ct-scanner,slesvig-holstener,skærmskåner,barthianer,skorzoner,paraguayaner,syttener,-tonner,presbyterianer,antiguaner,kapuciner,lipizzaner,abessiner,femtener,tre-i-ener,ocr-scanner,hillerødaner,kantianer,javaner,puebloindianer,bahamaner,centralafrikaner,attener,bretagner,fugtfjerner,skælskørianer,dominicaner,brandesianer,alemanner,meljævner,provinsianer,sekstener,sleepingpartner,beniner	banner,centner
3	ide	74	0.00077	73	1	side,hjemmeside,forside,guide,bagside,pyramide,inderside,ride,slagside,skyggeside,slide,yderside,underside,æggehvide,langside,asteroide,sylfide,bredside,offside,sydside,plusside,helside,overside,venstreside,højreside,mide,solside,hvide,sportsside,blide,søside,minusside,indtægtsside,ringside,udgiftsside,hæmoride,positivside,skibsside,vrangside,spindeside,landside,androide,kvide,druide,natside,midterside,startside,negativside,støvmide,spindemide,flæskeside,læside,retside,geoide,karyatide,normalside,danaide,fnatmide,sværdside,vindside,galmide,skabmide,ægide,ellipsoide,mandsside,planetoide,udside,nereide,debetside,eumenide,svartside,ostemide,smalside	sous vide
3	rie	155	0.00077	81	74	historie,serie,ferie,sommerferie,bakterie,tegneserie,efterårsferie,verdenshistorie,vinterferie,kunsthistorie,kalorie,kulturhistorie,forhistorie,juleferie,kærlighedshistorie,litteraturhistorie,arie,livshistorie,prærie,glorie,injurie,valkyrie,charterferie,materie,solstrålehistorie,røverhistorie,løgnehistorie,skoleferie,idéhistorie,vandrehistorie,brie,kirkehistorie,sygehistorie,godnathistorie,storbyferie,samtidshistorie,colibakterie,bibelhistorie,bilferie,retshistorie,religionshistorie,furie,naturhistorie,filmserie,videnskabshistorie,industriferie,curie,arterie,bededagsferie,sproghistorie,bondegårdsferie,kurie,industrihistorie,læseferie,molbohistorie,socialhistorie,kroferie,solohistorie,vandreferie,nerie,cikorie,ammestuehistorie,personalhistorie,storebededagsferie,kanoferie,kilokalorie,vrøvlehistorie,aktivferie,koronararterie,koloraturarie,helgenglorie,knoldbakterie,ingridmarie,almanakhistorie,skipperhistorie,aarhushistorie,samarie,stavbakterie,bravurarie,infusorie,kør selv-ferie	scenarie,skrækscenarie,drømmescenarie,mitokondrie,kriterie,succeskriterie,mysterie,kyrie,laboratorie,akvarie,territorie,solarie,konservatorie,terrarie,ingridmarie,imperie,seminarie,ovarie,auditorie,klimaministerie,pædagogseminarie,beskæftigelsesministerie,landbrugsministerie,moratorie,planetarie,sanatorie,sælarie,miljøministerie,fødestedskriterie,justitsministerie,erhvervsministerie,udviklingsministerie,sproglaboratorie,delfinarie,martyrie,skatteministerie,dentallaboratorie,socialministerie,suppositorie,klimakterie,alkoholambulatorie,dødskriterie,ferskvandsakvarie,undervisningsministerie,transportministerie,kommissorie,observatorie,økonomiministerie,udenrigsministerie,ressortministerie,søterritorie,svangreambulatorie,finansministerie,kulturministerie,ambulatorie,pastoralseminarie,eksperimentarie,finansimperie,musikkonservatorie,fagministerie,statsministerie,ministerie,fødevareministerie,forretningsministerie,kirkeministerie,krematorie,trafikministerie,oratorie,forskningsministerie,energiministerie,boligministerie,forsvarsministerie,indenrigsministerie,sundhedsministerie
3	lag	114	0.00075	3	111	jetlag,plag,hingsteplag	forslag,grundlag,slag,forlag,nederlag,lovforslag,flag,indslag,afslag,beslutningsforslag,oplag,udslag,bilag,opslag,anslag,underlag,omslag,folkeslag,nabolag,tilbageslag,beslag,nedslag,fodslag,vederlag,hammerslag,sindelag,bagslag,kanonslag,spareforslag,håndslag,vækstlag,samfundslag,håndelag,ozonlag,sværdslag,lovgrundlag,hjerteslag,dannebrogsflag,overslag,jetlag,jordlag,trylleslag,søslag,dueslag,hedeslag,fedtlag,mellemlag,pulsslag,liggeunderlag,punktnedslag,rekrutteringsgrundlag,gennemslag,bogomslag,prislag,vingeslag,isslag,ridderslag,dørslag,regnslag,drikkelag,taktslag,kølleslag,pladeomslag,bølgeslag,stenslag,islag,håndkantslag,stokkeslag,splitflag,klokkeslag,bekvemmelighedsflag,bråvallaslag,restoplag,smudsomslag,modforslag,pudslag,signalflag,timeslag,spæklag,digelag,orlogsflag,sydstatsflag,skriveunderlag,genopslag,kuskeslag,luftslag,vinkelbeslag,bedeslag,hovslag,tilslag,arkipelag,vennelag,isoleringslag,stillag,hjertelag,trafikunderlag,stutflag,bommesislag,kvarterslag,efterslag,kullag,toldoplag,overhåndsslag,klæglag,pumpelag,tøjreslag,ramslag,bislag,underslag,paskvilbeslag,trækgrundlag
3	amp	76	0.00074	73	3	kamp,valgkamp,landskamp,svamp,hjemmekamp,fodboldkamp,camp,damp,kvalifikationskamp,træningskamp,udekamp,returkamp,kulturkamp,testkamp,pokalkamp,skimmelsvamp,hamp,ligakamp,nærkamp,klassekamp,frihedskamp,åbningskamp,gadekamp,slåskamp,håndboldkamp,titelkamp,ildkamp,omkamp,kvindekamp,boksekamp,tvekamp,vanddamp,slutkamp,divisionskamp,dødskamp,skæbnekamp,playoffkamp,femkamp,tamp,fluesvamp,brydekamp,ishockeykamp,vandkamp,revanchekamp,gladiatorkamp,gærsvamp,tikamp,vamp,bootcamp,sneboldkamp,pudekamp,fodsvamp,hussvamp,karljohansvamp,tavlesvamp,hatsvamp,fyrsvamp,snydetamp,rustsvamp,rådsvamp,poresvamp,spændetamp,stinksvamp,jakobskamp,skivesvamp,spilddamp,brandsvamp,blomkålssvamp,manilahamp,væddekamp,viftesvamp,vingesvamp,trøffelsvamp	tramp,stamp,støvletramp
3	tør	110	0.00073	110	0	direktør,instruktør,redaktør,aktør,chefredaktør,filminstruktør,vicedirektør,sportsdirektør,amatør,underdirektør,importør,kommunaldirektør,debattør,bankdirektør,restauratør,inspektør,observatør,skoleinspektør,generaldirektør,kriminalinspektør,operatør,politiinspektør,distributør,eksportør,teaterdirektør,installatør,kulturredaktør,portør,projektør,skulptør,provokatør,montør,medredaktør,konstruktør,landinspektør,speditør,skoledirektør,socialdirektør,stør,auditør,desertør,overinspektør,viceinspektør,sabotør,sceneinstruktør,akkompagnatør,translatør,navigatør,kollaboratør,kreatør,transportør,dekoratør,elinstallatør,konduktør,rapportør,brandinspektør,akupunktør,volontør,programredaktør,reparatør,blomsterdekoratør,udlandsredaktør,brevkasseredaktør,parallelimportør,undervisningsinspektør,hovedredaktør,kronikredaktør,domptør,generalauditør,undervisningsdirektør,repetitør,innovatør,manuduktør,rekvisitør,stukkatør,struktør,ordbogsredaktør,førstedirektør,rygestopinstruktør,sanitør,filmoperatør,trafikinformatør,portrættør,kølemontør,billettør,sporvognskonduktør,branddirektør,ekspeditør,flyveinstruktør,isolatør,elektroinstallatør,informatør,plantør,lektør,kollektør,korrektør,traktør,kolportør,tasteoperatør,fabriksinspektør,destillatør,godsekspeditør,bygningskonduktør,sikringsmontør,postekspeditør,renovatør,demonstratør,desinfektør,ventilatør,kooperatør	
3	ank	27	0.00073	25	2	bank,tank,centralbank,tænketank,hank,pengetank,skavank,stank,netbank,benzintank,blodbank,sædbank,skank,brændstoftank,jobbank,septiktank,databank,genbank,biobank,krank,rådnetank,sladderhank,vævsbank,trikstank,rubank	bank,pjank
3	ads	91	0.00073	83	8	plads,arbejdsplads,andenplads,parkeringsplads,førsteplads,tredjeplads,sejlads,legeplads,campingplads,byggeplads,praktikplads,markedsplads,losseplads,genbrugsplads,siddeplads,gårdsplads,læreplads,rasteplads,tilskuerplads,sengeplads,spalteplads,sidsteplads,kapsejlads,flyveplads,skueplads,gravplads,kampplads,boplads,sportsplads,studieplads,holdeplads,ladeplads,benplads,friplads,soveplads,begravelsesplads,handelsplads,ståplads,hjemmearbejdsplads,tilhørerplads,stadeplads,krigsskueplads,stamplads,tumleplads,lejrplads,busholdeplads,yngleplads,landingsplads,hædersplads,byggelegeplads,forplads,standplads,bajads,skabsplads,vinduesplads,gydeplads,valplads,kanosejlads,vendeplads,julestads,vægplads,bådeplads,stejleplads,aflæggeplads,liggeplads,spildplads,køjeplads,skrammellegeplads,stads,orkesterplads,restplads,sukkerstads,udenomsplads,tømmerplads,tørreplads,fyldplads,skydeplads,materialeplads,dæksplads,brætsejlads,lasteplads,p-plads,flitterstads	palads,stillads,morads,buskads,krads,stads,sukkerstads,udkrads
3	tal	101	0.00070	21	80	kapital,egenkapital,aktiekapital,portal,krystal,piedestal,startkapital,internetportal,lånekapital,iskrystal,dødsmetal,total,fraktal,dental,bjergkrystal,driftskapital,palatal,subtotal,labiodental,death metal,heavy metal	antal,flertal,hospital,kvartal,mindretal,metal,universitetshospital,nøgletal,privathospital,utal,seertal,indbyggertal,årstal,overtal,timetal,fåtal,stemmetal,krystal,tungmetal,undertal,kolesteroltal,fødselstal,børnehospital,kondital,tusindtal,ental,ædelmetal,læsertal,militærhospital,procenttal,iskrystal,pointtal,mørketal,mandtal,primtal,sidetal,ottetal,ettal,total,indbyggerantal,syvtal,romertal,lixtal,indekstal,pristal,letmetal,bjergkrystal,firtal,daghospital,femtal,fordelingstal,tital,hundredtal,sekstal,nærhospital,nital,endetal,forholdstal,nødhospital,heltal,tretal,grundtal,cirkatal,attenhundredetal,tantal,kvadrattal,hårdmetal,kardinaltal,nittenhundredetal,arabertal,ordenstal,ellevetal,hvidmetal,kubiktal,mængdetal,kontakttal,tolvtal,trettental,cetantal,ordinaltal
3	ler	326	0.00070	314	12	spiller,skuespiller,forhandler,maler,fodboldspiller,fortæller,landsholdsspiller,israeler,ejendomsmægler,kansler,handler,sagsbehandler,bestseller,mægler,sejler,thriller,samler,medspiller,trailer,forbundskansler,udstiller,fortaler,boghandler,taler,afspiller,håndboldspiller,behandler,tennisspiller,kunstmaler,svindler,stregspiller,pendler,butler,betaler,formidler,modspiller,føler,udvikler,indsamler,bejler,forslagsstiller,måler,kontroller,menneskesmugler,tvivler,grønthandler,chefforhandler,børsmægler,nøglespiller,stiller,smugler,avler,fiskehandler,stamspiller,brøler,møller,gøgler,kantspiller,bagspiller,uddeler,historiefortæller,tæller,narkohandler,meddeler,controller,kunsthandler,køler,skakspiller,biavler,hykler,topforhandler,vinhandler,trawler,markspiller,pladespiller,lystsejler,tørretumbler,mellemhandler,våbenhandler,ishockeyspiller,cykelhandler,dealer,neandertaler,brugsuddeler,rigsdaler,seycheller,blomsterhandler,rottweiler,healer,frugtavler,højtaler,filmskuespiller,elmåler,detailhandler,efternøler,spoiler,boldspiller,juveler,daler,valutahandler,farvehandler,jegfortæller,landmåler,ostehandler,kavaler,hæler,karakterskuespiller,gambler,vinavler,skibsmægler,spiludvikler,fotohandler,ejendomshandler,dyrehandler,kvægavler,antikvarboghandler,kuller,storsvindler,dobbeltsculler,spilfordeler,kontraktspiller,portrætmaler,fartmåler,undermåler,galler,gadehandler,rigskansler,pelsdyravler,varmeveksler,krejler,sampler,curler,singlesculler,dødssejler,fritidssejler,skridttæller,spiler,systemudvikler,kilometertæller,rumdeler,manufakturhandler,kriller,kapsejler,fløjtespiller,menneskehandler,kartoffelskræller,tørvetriller,sjæler,flaskesamler,mursejler,kortspiller,bugtaler,spindler,hækspoiler,produktudvikler,skiltemaler,wobler,bowler,motorsejler,forlagsboghandler,tyroler,herreekviperingshandler,plimsoller,triptæller,emmentaler,grubler,slavehandler,eneforhandler,sprinkler,tumbler,tursejler,orgelspiller,marinemaler,frimærkehandler,geigertæller,skjuler,hyler,urtepotteskjuler,vildthandler,vindmåler,angler,kæberasler,ramler,højdemåler,frugthandler,krakiler,omdeler,taskenspiller,tumler,pelsavler,veksler,tobakshandler,varmemåler,wrestler,reservespiller,æggedeler,vinkøler,benzinmåler,violinspiller,hønseavler,hockeyspiller,forædler,interrailer,knæler,regnmåler,børnemishandler,fisketrawler,fredsføler,gørtler,strømfordeler,stemmetæller,harpespiller,møntsamler,kreaturhandler,hasardspiller,cricketspiller,modehandler,champagnekøler,kvæler,orientaler,opvigler,båndspiller,sangskjuler,udhaler,opstiller,trykmåler,nøler,falskspiller,skumler,medbejler,brætsejler,tåhyler,vinkelmåler,mishandler,betler,cigarhandler,fumler,opmåler,overhaler,kveller,sculler,økuller,bengaler,kaninavler,afstandsmåler,lysmåler,gærdespiller,værdimåler,arbejdsformidler,produkthandler,støjmåler,tipsforhandler,viktualiehandler,kapitalbrøler,gumler,provencaler,cigarruller,bladhandler,pejler,klatmaler,spritsmugler,fugtighedsmåler,kabyler,fedtspiller,fuglehandler,skibshandler,båndafspiller,tredjepersonsfortæller,dukkespiller,kornhandler,genremaler,gyvelkvæler,gasmåler,dybdemåler,struggler,miniaturemaler,gæler,bundskjuler,vikler,sprøjtemaler,freskomaler,afvikler,anatoler,padler,beskeler,italer,CD-afspiller,satellithøjtaler,førstepersonsfortæller,kolonialhandler,marstaller,stempler,skjaller,praler,hvirvler,båndtæller,stabler,stemmesamler,frispiller,takkemåler,underhandler,skåltaler,rysler,spildsamler,stjæler,dråbetæller,fidusmaler,udskiller,fodhviler,materialhandler,dummyspiller,gradmåler,storyteller,gaffelstabler	moler,kriller,fnuller,moræneler,rødler,blåler,pibeler,bandoler,dillerdaller,hverken-eller,valkeler,enten-eller
3	ole	79	0.00070	79	0	skole,folkeskole,højskole,kjole,efterskole,handelshøjskole,friskole,musikskole,handelsskole,privatskole,ungdomsskole,landbohøjskole,parole,grundskole,kostskole,aftenskole,mole,planteskole,realskole,lærerhøjskole,specialskole,produktionsskole,lejrskole,statsskole,folkehøjskole,professionshøjskole,daghøjskole,danseskole,officersskole,brudekjole,rideskole,kommuneskole,centralskole,sygeplejeskole,spole,køreskole,købmandsskole,pigeskole,lilleskole,søndagsskole,præstekjole,enhedsskole,natkjole,forskole,flinkeskole,dåbskjole,underkjole,guacamole,banderole,døveskole,førskole,dagskole,cocktailkjole,fysioterapeutskole,filmspole,brevskole,skjortekjole,hjælpeskole,alveole,dækmole,karambole,barneskole,centerskole,empirekjole,pogeskole,vakuole,ergoterapeutskole,drosselspole,camisole,systole,sortkjole,eksternatskole,barkarole,trebandekarambole,lamékjole,diastole,åbenplanskole,atlaskeskjole,fole	
3	tat	44	0.00069	27	17	stat,traktat,delstat,nationalstat,retsstat,diktat,forbundsstat,etat,østat,politistat,termostat,slyngelstat,småstat,oliestat,fotostat,helstat,lydstat,vasalstat,fristat,satellitstat,randstat,postetat,potentat,hofstat,batat,arabstat,reostat	resultat,citat,notat,attentat,valgresultat,diktat,implantat,habitat,søgeresultat,undersøgelsesresultat,delresultat,acetat,laktat,tandimplantat,transplantat,cochleaimplantat,transportat
3	pel	30	0.00067	17	13	appel,discipel,gospel,kuppel,knippel,propel,poppel,skalpel,vimpel,humpel,løgkuppel,ampel,rappel,mispel,nippel,trempel,kvadrupel	eksempel,tempel,kapel,stempel,skoleeksempel,gummistempel,gravkapel,poststempel,buddhisttempel,frankostempel,tidsstempel,prægestempel,standardeksempel
3	tid	121	0.00066	116	5	fremtid,fortid,nutid,fritid,ventetid,arbejdstid,mellemtid,åbningstid,spilletid,levetid,datid,årstid,samtid,skoletid,lukketid,eftertid,efterkrigstid,højtid,oldtid,krisetid,deltid,studietid,livstid,overtid,vikingetid,løbetid,juletid,istid,sendetid,myldretid,rekordtid,oplysningstid,taletid,betænkningstid,sommertid,læretid,mellemkrigstid,midnatstid,sengetid,middellevetid,spørgetid,spisetid,spildtid,vintertid,mødetid,fredstid,liggetid,agurketid,regntid,kvalitetstid,telefontid,flyvetid,træffetid,besøgstid,hviletid,nattetid,nytårstid,ekspeditionstid,sejltid,aftenstid,spærretid,urtid,realtid,yngletid,heltid,kridttid,tjenestetid,mellemistid,kirketid,flekstid,inkubationstid,sluttid,fastetid,førkrigstid,karenstid,klunketid,ulvetid,forårstid,ankomsttid,parringstid,normaltid,tørtid,tørretid,tertiærtid,butikstid,juratid,brunsttid,nedetid,dyrtid,oppetid,latenstid,kvartærtid,væksttid,kultid,førnutid,efterårstid,førdatid,midsommertid,dolktid,rotationstid,fikstid,glacialtid,førfremtid,ramletid,kælvetid,gåtid,sværmetid,voksetid,køre-hvile-tid,diluvialtid,triastid,zonetid,alluvialtid,hævdstid,slagtetid,cirkatid	måltid,mellemmåltid,festmåltid,aftensmåltid,prøvemåltid
3	tur	170	0.00065	147	23	kultur,natur,litteratur,struktur,temperatur,skulptur,nedtur,arkitektur,infrastruktur,tortur,rundtur,konjunktur,gåtur,signatur,køretur,cykeltur,kandidatur,karikatur,optur,vandretur,løbetur,kontur,sejltur,skønlitteratur,højkonjunktur,bytur,lavkonjunktur,madkultur,spadseretur,subkultur,faglitteratur,skovtur,akupunktur,fisketur,virksomhedskultur,verdenslitteratur,hjemtur,korrektur,træningstur,travetur,positur,aftentur,statsadvokatur,statur,finkultur,druktur,tekstur,muskulatur,popkultur,stuetemperatur,modkultur,ridetur,smuttur,børnekultur,slentretur,langtur,sviptur,hedetur,massekultur,fraktur,dagtemperatur,hyttetur,gårdtur,svedetur,lejrtur,folkekultur,springtur,retur,triviallitteratur,overlevelsestur,stroppetur,akvakultur,mikstur,rystetur,udtur,koloratur,bakteriekultur,renkultur,kvadratur,telttur,svingtur,begivenhedskultur,nattemperatur,køkultur,undergrundskultur,røvtur,kælketur,forbrugerkultur,singlekultur,manufaktur,fornøjelsestur,machokultur,pakketur,sutur,storbykultur,nulfejlskultur,ruptur,sekundærlitteratur,unatur,københavnertur,advokatur,krænkelseskultur,nomenklatur,utur,mayakultur,kanetur,kiosklitteratur,politur,rigsadvokatur,ligatur,mandetur,vævskultur,punktur,spillernatur,emigrantlitteratur,undergrundslitteratur,makulatur,stukkatur,gærkultur,titulatur,inuitkultur,registratur,smudslitteratur,dybdestruktur,totur,autokorrektur,politiadvokatur,tinktur,sekstur,enspændernatur,memoirelitteratur,intendantur,damkultur,jodtinktur,kommandantur,investitur,receptur,inkakultur,urstruktur,adjudantur,e-signatur,konjektur,kvæstur,agrikultur,tur-retur,kontrasignatur,appretur	diktatur,kandidatur,agentur,tastatur,partitur,kreatur,apparatur,militærdiktatur,armatur,miljøagentur,klaviatur,pulpitur,advokatur,minutur,demokratur,imprimatur,ungkreatur,adjunktur,præfektur,generalagentur,docentur,kontaktur,receptur
3	alg	59	0.00065	1	58	talg	valg,salg,udvalg,præsidentvalg,folketingsvalg,kommunalvalg,kulturudvalg,billetsalg,genvalg,udsalg,socialudvalg,forretningsudvalg,finansudvalg,primærvalg,frasalg,fravalg,ordvalg,detailsalg,forsalg,nyvalg,førstevalg,kampvalg,midtvejsvalg,formandsvalg,kommunevalg,samarbejdsudvalg,videresalg,skolevalg,tilvalg,omvalg,prøvevalg,løssalg,lagersalg,kanonvalg,mersalg,suppleringsvalg,januarudsalg,tvangssalg,fredsvalg,dørsalg,apoteksudsalg,styksalg,håndkøbsudsalg,gensalg,forvalg,responsumudvalg,bortsalg,indvalg,oversalg,katalogsalg,gennemvalg,børn og unge-udvalg,slagteriudsalg,slutsalg,undersalg,bortvalg,glosevalg,børne- og ungeudvalg
3	tor	222	0.00064	202	20	investor,sektor,motor,lektor,faktor,rektor,kommentator,diktator,senator,kreditor,factor,kurator,traktor,elevator,pastor,spindoktor,dieselmotor,koordinator,doktor,mentor,sundhedssektor,indikator,benzinmotor,administrator,katalysator,reaktor,radiator,promotor,generator,protektor,servicesektor,respirator,illustrator,prorektor,rollator,konservator,kiropraktor,universitetslektor,monitor,nestor,inspirator,ækvator,konditor,gladiator,receptor,projektor,atomreaktor,detektor,organisator,reformator,æresdoktor,debitor,simulator,havetraktor,metaldetektor,påhængsmotor,ventilator,transistor,alligator,triumfator,studielektor,forbrændingsmotor,kommunikator,motivationsfaktor,animator,kantor,seminarielektor,accelerator,stressfaktor,seminarierektor,visitator,agitator,vektor,eksaminator,stabilisator,boksepromotor,tutor,vibrator,karburator,transformator,detonator,jetmotor,bådmotor,regulator,kondensator,inspektor,taksator,moderator,rotor,elektromotor,hjælpemotor,heksedoktor,tidsfaktor,manipulator,likvidator,løgnedetektor,akkumulator,emulgator,improvisator,eksekutor,kolonisator,autor,inhalator,totalisator,solfaktor,operator,polyhistor,donator,innovator,inkvisitor,hækmotor,imitator,reflektor,registrator,inhibitor,rugbrødsmotor,inkassator,totaktsmotor,defibrillator,konspirator,gymnasielektor,kultivator,letvandsreaktor,eksperimentator,isolator,makulator,testator,overheadprojektor,boksermotor,kernereaktor,evaluator,stimulator,røgdetektor,vareelevator,prokurator,observator,formeringsreaktor,restaurator,imperator,recitator,instruktor,popularisator,duplikator,aktor,beskyttelsesfaktor,auditor,stempelmotor,oscillator,usurpator,plagiator,kalkulator,informator,applikator,udenbordsmotor,chillfaktor,artdirector,prosektor,separator,firetaktsmotor,eksplosionsmotor,kvæstor,analysator,kompensator,induktor,primfaktor,tabulator,termistor,filtrator,tyristor,retor,evaporator,konvektor,mediator,demodulator,versifikator,kontaktor,facilitator,infiltrator,kommutator,alkvantor,demonstrator,fundator,regenerator,destillator,injektor,eskalator,deklamator,rhesusfaktor,identifikator,paternosterelevator,refraktor,konduktor,orator,multiplikator,laborator,kvantor,velociraptor,ejektor,primus motor,transduktor,kompilator,vivisektor	kontor,turistkontor,postkontor,bistandskontor,socialkontor,billetkontor,kommunekontor,kirkekontor,forkontor,motorkontor,dommerkontor,storrumskontor,vekselkontor,enmandskontor,toldkontor,notarialkontor,rodekontor,lånekontor,kassererkontor,ministerialkontor
3	ave	73	0.00063	68	5	opgave,have,udgave,børnehave,gave,mave,pave,julegave,slave,baghave,dyrehave,kolonihave,enklave,køkkenhave,stave,krave,gårdhave,forhave,kerneopgave,urtehave,førsteudgave,mandelgave,bryllupsgave,skovbørnehave,vinterhave,nådegave,originaludgave,prisopgave,nyttehave,specialopgave,frugthave,trave,netudgave,topmave,skrankepave,konfirmationsgave,prydhave,rullekrave,agave,udflytterbørnehave,præstekrave,aftershave,hadegave,vuggegave,lønslave,morgengave,billigudgave,pibekrave,piratudgave,adventsgave,galejslave,tave,sjalskrave,votivgave,klassikerudgave,etbindsudgave,tekstopgave,bærekrave,gudegave,eksklave,bibliofiludgave,multiple choice-opgave,ulave,krydsogtværsopgave,ottave,bladmave,netmave,matroskrave	rave,bohave,konklave,musthave,ulave
3	nce	96	0.00063	96	0	chance,konkurrence,alliance,balance,konference,kompetence,annonce,distance,ambulance,nuance,tolerance,reference,assistance,renæssance,pressekonference,betalingsbalance,leverance,elegance,seance,korrespondance,performance,arrogance,ubalance,præference,avance,intolerance,romance,excellence,handelsbalance,dødsannonce,inkompetence,restance,jobannonce,spidskompetence,trance,difference,dekadence,kadence,fredskonference,lægeambulance,nultolerance,diligence,ounce,breakdance,kontaktannonce,fajance,eminence,videokonference,langdistance,bruttoavance,ekstravagance,kontrachance,clairvoyance,renonce,terrorbalance,væskebalance,kulance,sixpence,mellemdistance,ignorance,squaredance,assurance,underleverance,kondolence,nonchalance,gættekonkurrence,overbalance,hormonbalance,rubrikannonce,gevinstchance,reassurance,absence,mesalliance,underbalance,hjerteambulance,juleassistance,indifference,remonce,kortdistance,kapitalbalance,vakance,præmiekonkurrence,tekstannonce,laktoseintolerance,topkonference,saldobalance,linedance,råbalance,korpulence,kontenance,adhærence,tripelalliance,fifty-fifty-chance,kværulance,usance,ækvidistance	
3	lan	51	0.00063	38	13	plan,lokalplan,handlingsplan,landsplan,køreplan,tidsplan,klan,redningsplan,helhedsplan,handleplan,fremtidsplan,masterplan,læseplan,vagtplan,læreplan,byplan,regionplan,slagplan,nødplan,grundplan,kostplan,femårsplan,kapellan,elan,fartplan,timeplan,bordplan,togplan,galan,sommerkøreplan,langtidsplan,kaldskapellan,perspektivplan,fredningsplan,regionalplan,raglan,situationsplan,hortulan	plan,landsplan,verdensplan,gadeplan,topplan,skråplan,stueplan,amatørplan,jordplan,biplan,monoplan,bæreplan,hydroplan
3	olk	22	0.00063	5	17	tolk,forretningsfolk,dolk,ædedolk,simultantolk	folk,godtfolk,mandfolk,fodfolk,broderfolk,stammefolk,kulturfolk,naturfolk,kvindfolk,herrefolk,værtsfolk,elverfolk,urfolk,karlfolk,høstfolk,dværgfolk,hestfolk
3	rke	108	0.00061	54	54	kirke,styrke,mærke,folkekirke,domkirke,arbejdsstyrke,tørke,specialstyrke,fredsstyrke,viljestyrke,frikirke,råstyrke,klosterkirke,sognekirke,landsbykirke,lydstyrke,lysstyrke,udrykningsstyrke,vindstyrke,sanglærke,muskelstyrke,lærke,slidstyrke,elitestyrke,orkanstyrke,strømstyrke,indsatsstyrke,rundkirke,stormstyrke,slagstyrke,romerkirke,stavkirke,karakterstyrke,oldkirke,lommelærke,skovmærke,pavekirke,moderkirke,sikringsstyrke,brudstyrke,beredskabsstyrke,korskirke,synsstyrke,vejkirke,sjælsstyrke,toplærke,vandrekirke,kropsstyrke,bomlærke,strækstyrke,annekskirke,åndsstyrke,rivstyrke,højkirke	mærke,virke,mørke,varemærke,frimærke,samvirke,mindesmærke,bilmærke,pejlemærke,klistermærke,tusmørke,julemærke,adelsmærke,miljømærke,rygmærke,energimærke,halvmørke,kendemærke,vintermørke,vandmærke,bogmærke,modermærke,bomærke,brændemærke,landemærke,sømærke,prismærke,idrætsmærke,strækmærke,samlingsmærke,kendingsmærke,lurmærke,buldermørke,premiummærke,kainsmærke,kradsemærke,landmærke,våbenmærke,stempelmærke,sugemærke,firmamærke,spillemærke,klæbemærke,bælgmørke,enemærke,identitetsmærke,øremærke,fabriksmærke,særmærke,manilamærke,gradsmærke,tokronersfrimærke,skelnemærke,tiøresfrimærke
3	mer	195	0.00061	129	66	sommer,dommer,efterkommer,hammer,svømmer,romer,sensommer,hummer,landsdommer,forsommer,smagsdommer,drømmer,kræmmer,performer,bornholmer,timer,stammer,farmer,selskabstømmer,khmer,strammer,glimmer,vækstfremmer,jomfruhummer,femmer,isenkræmmer,strømer,lægdommer,byretsdommer,eftersommer,overdommer,transformer,krammer,jammer,summer,linjedommer,bænkevarmer,streamer,midsommer,ymer,bedømmer,polymer,publikummer,himmelstormer,natsværmer,emmer,kriminaldommer,forhammer,stockholmer,sværmer,vandvarmer,opstrammer,slumstormer,dunhammer,civildommer,dagdrømmer,slangetæmmer,slummer,brummer,omformer,klaverstemmer,kødhammer,terrassevarmer,lægtehammer,benvarmer,minkfarmer,mimer,løvetæmmer,oldtimer,kummer,sidedommer,rygsvømmer,brystsvømmer,hosekræmmer,sjælevarmer,skærsommer,dybvandshummer,dyretæmmer,dørhammer,kattejammer,pianostemmer,urtekræmmer,tevarmer,flottenhejmer,former,dosmer,damphammer,aftensværmer,køllesværmer,torshammer,ligustersværmer,murerhammer,fredsdommer,klaphammer,bissekræmmer,bismer,pappenhejmer,hemmelighedskræmmer,kløfthammer,forvarmer,knævarmer,fagfællebedømmer,skægtrimmer,stemmer,kludekræmmer,mælkeskummer,flammehæmmer,næsehårstrimmer,instagrammer,gennemløbsvandvarmer,elastomer,bænkhammer,ejdammer,sættedommer,pikhammer,surinamer,disclaimer,spidshammer,bøhmer,frisvømmer,pelsfarmer,broholmer,desmer,gamer,flækhammer,indian summer,boomer,ommer,planerhammer	nummer,telefonnummer,kammer,hummer,handelskammer,postnummer,ekstranummer,glimmer,gaskammer,personnummer,slagnummer,spisekammer,tømmer,skatkammer,flimmer,gravkammer,fruentimmer,fupnummer,pulterkammer,temanummer,andetkammer,hjertekammer,drivtømmer,mørkekammer,toldkammer,særnummer,glansnummer,deputeretkammer,hjerteflimmer,sovekammer,torturkammer,katalognummer,serienummer,matrikelnummer,lønkammer,studerekammer,trykkammer,forrådskammer,paradenummer,frinummer,forkammer,løbenummer,atomnummer,ekkokammer,førstekammer,skonummer,karlekammer,journalnummer,lokalnummer,brændkammer,klovnenummer,områdenummer,privatnummer,tagkammer,bravurnummer,slusekammer,hofnummer,hjemmenummer,rustkammer,CVR-nummer,kvistkammer,gavntømmer,garderobenummer,vragtømmer,desmer,CPR-nummer
3	avn	57	0.00060	22	35	havn,lufthavn,gavn,ravn,favn,hjemstavn,natteravn,fastelavn,frihavn,fiskerihavn,inderhavn,trafikhavn,bådehavn,agterstavn,forstavn,stavn,natravn,nødhavn,bavn,dokhavn,bagstavn,valravn	navn,gavn,efternavn,savn,tilnavn,fornavn,kælenavn,øgenavn,hovednavn,afsavn,topnavn,dæknavn,kunstnernavn,stednavn,mellemnavn,firmanavn,verdensnavn,gadenavn,pigenavn,brugernavn,kaldenavn,slægtsnavn,personnavn,drengenavn,egennavn,fællesnavn,kvindenavn,artsnavn,døbenavn,marknavn,mandsnavn,giftenavn,trivialnavn,købenavn,sen-navn
3	ort	160	0.00059	81	79	rapport,sport,transport,eksport,port,hjort,abort,import,lort,sort,komfort,motorsport,sejlsport,support,carport,solsort,kampsport,tort,politirapport,godstransport,kronhjort,skisport,hjemtransport,travsport,elitesport,byport,hundelort,ladeport,nationalsport,halvårsrapport,holdsport,kornsort,ressort,ekstremsport,søsport,søtransport,folkesport,sygetransport,parallelimport,gitterport,bort,systemeksport,escort,rosport,vandsport,vintersport,bovport,siddekomfort,roquefort,situationsrapport,kultureksport,æresport,kontaktsport,eghjort,sluseport,heliport,dåhjort,møntsort,sikahjort,reeksport,dekort,vinsort,skydesport,gangsport,mæanderbort,chokrapport,vippeport,moskushjort,terrænsport,retort,reimport,merimport,ægeksport,a la grecque-bort,parasport,interimsrapport,ribbebort,e-sport,bøghjort,vandresport,tidkort	kort,kørekort,lort,dankort,kreditkort,postkort,landkort,gavekort,menukort,visitkort,verdenskort,fort,betalingskort,klippekort,julekort,vinkort,girokort,spisekort,skattekort,søkort,buskort,rejsekort,hævekort,liftkort,kontokort,valgkort,bykort,årskort,månedskort,taletidskort,spillekort,ressort,frikort,grafikkort,identitetskort,resort,lydkort,pressekort,sæsonkort,togkort,nøglekort,periodekort,lånerkort,partoutkort,bordkort,fiskekort,vejrkort,boardingkort,brevkort,takkekort,telekort,netkort,printkort,pensionistkort,købekort,billedkort,skærmkort,tarokkort,sankekort,stamkort,bikort,hovedkort,generalstabskort,titurskort,indbydelseskort,adressekort,vægkort,ID-kort,bruttotrækkort,sim-kort,firkort,københavnskort,vandrerkort,trækkort,fælleskort,fanekort,bornholmskort,konturkort,reliefkort
3	ekt	51	0.00057	36	15	effekt,respekt,arkitekt,sekt,dialekt,drivhuseffekt,landskabsarkitekt,selvrespekt,stadsarkitekt,konfekt,defekt,affekt,sideeffekt,lydeffekt,dominoeffekt,havearkitekt,præfekt,langtidseffekt,despekt,disrespekt,lakridskonfekt,bieffekt,kollekt,dobbeltkonfekt,bygningsarkitekt,indendørsarkitekt,knaldeffekt,sociolekt,multietnolekt,dopplereffekt,gøgeungeeffekt,snobbeeffekt,kronolekt,etnolekt,strækeffekt,idiolekt	projekt,aspekt,insekt,objekt,byggeprojekt,pilotprojekt,prospekt,intellekt,subjekt,beskæftigelsesprojekt,børsprospekt,skitseprojekt,samleobjekt,kønsobjekt,detailprojekt
3	ade	160	0.00056	157	3	gade,skade,plade,overflade,ballade,ambassade,chokolade,facade,lade,nummerplade,flade,hovedgade,gågade,parade,blokade,brigade,spade,barrikade,hjerneskade,knæskade,arbejdsskade,bordplade,rokade,sidegade,bygade,marinade,marmelade,esplanade,håndflade,personskade,promenade,sendeflade,kaskade,nomade,vandskade,boldgade,vandoverflade,eskapade,rygskade,myriade,arkade,kogeplade,olympiade,strandpromenade,kavalkade,boglade,regeringsrokade,brugerflade,berøringsflade,remoulade,programflade,vade,maskerade,brudflade,serenade,grammofonplade,kontaktflade,ministerrokade,tirade,spånplade,spilleplade,høreskade,handelsgade,cikade,brandskade,grænseflade,roulade,karbonade,stormskade,fugtskade,farvelade,vagtparade,brugergrænseflade,snitflade,frostskade,pålægschokolade,museskade,printplade,palisade,triade,strandskade,jade,følgeskade,staklade,brokade,singleplade,sivegade,epiduralblokade,perleplade,idrætsskade,lyskenskade,læbepomade,busgade,sætningsskade,kanonade,selvskade,jeremiade,hystade,lemonade,balustrade,morgenflade,fodparade,vægflade,blodplade,kolonnade,dekade,skovskade,aftenflade,maskinskade,tapenade,pomade,panade,flødechokolade,najade,robinsonade,tornskade,retirade,krydsfinerplade,orangemarmelade,dryade,totalskade,bravade,vinterolympiade,grundflade,stillegade,solskade,sideflade,tyggeflade,mænade,finerplade,estrade,kogechokolade,krustade,haglskade,orangeade,harlekinade,laminatplade,dessertchokolade,kegleflade,skumcikade,kræftskade,galopade,ingefærmarmelade,akkolade,parerplade,tamponade,krokade,sommerolympiade,blindgade,LP-plade,lit de parade,prægeplade,gæstebudsskade,slidflade,diagonalgade,strygeflade,vifteparade	stade,bistade,stolestade
3	eri	385	0.00056	8	377	periferi,selleri,bladselleri,blegselleri,knoldselleri,dysenteri,difteri,beriberi	byggeri,maleri,galleri,rederi,røveri,tyveri,bryggeri,slagteri,batteri,fiskeri,mejeri,bedrageri,krydderi,skænderi,nybyggeri,fyrværkeri,skyderi,boligbyggeri,hykleri,bageri,gartneri,raseri,skriveri,maskineri,svineri,slaveri,lotteri,hysteri,forræderi,trykkeri,sceneri,lækkeri,persongalleri,drilleri,bankrøveri,artilleri,iværksætteri,tovtrækkeri,festfyrværkeri,broderi,hjemmerøveri,hemmelighedskræmmeri,oliemaleri,knivstikkeri,vaskeri,raffinaderi,kalkmaleri,bogholderi,hæleri,myrderi,klammeri,snyderi,gætteri,trylleri,drikkeri,lystfiskeri,snobberi,smugleri,vægmaleri,mikrobryggeri,stutteri,skønmaleri,pirateri,formynderi,tricktyveri,kunstgalleri,frieri,andelsmejeri,flerkoneri,jernstøberi,mytteri,roderi,karosseri,falskneri,rufferi,sløseri,olieraffinaderi,destilleri,lingeri,trakasseri,bogtrykkeri,københavneri,røgeri,kammerateri,orangeri,tiggeri,kavaleri,menageri,renseri,pakkeri,støberi,chikaneri,rytteri,klovneri,klasselotteri,sværmeri,brugstyveri,dyrplageri,føleri,drømmeri,infanteri,skilderi,glaspusteri,tapperi,prestigebyggeri,hulemaleri,artisteri,causeri,kætteri,krukkeri,fjerkræslagteri,identitetstyveri,hekseri,griseri,rambuktyveri,snedkeri,pamperi,praleri,overfiskeri,papirnusseri,møntvaskeri,mundhuggeri,fifleri,spilfægteri,bondefangeri,garveri,fjolleri,parfumeri,krybskytteri,småtteri,højforræderi,fiksfakseri,andelsslagteri,massehysteri,liebhaveri,ismejeri,mølleri,væveri,gæstgiveri,juleri,fantasteri,skoleskyderi,mosteri,terperi,tosseri,angiveri,skribleri,juristeri,pjækkeri,sørøveri,selvpineri,charcuteri,kæresteri,plattenslageri,retsmaskineri,falskmøntneri,lapperi,grubleri,blandingsbatteri,dagdrømmeri,sjuskeri,smøleri,koketteri,frimureri,kurmageri,industrifiskeri,dyneløfteri,ordkløveri,laksefiskeri,fluefiskeri,gendarmeri,stikkeri,kvaksalveri,hoveri,surmuleri,bryderi,kineseri,spøgeri,ligemageri,farveri,billedgalleri,draperi,spinderi,bogbinderi,dilettanteri,socialbedrageri,rygklapperi,plageri,fuskeri,gøgleri,overformynderi,pikanteri,fedteri,infirmeri,kafferisteri,flueknepperi,alfonseri,kandestøberi,hønseri,havfiskeri,rugeri,pedanteri,osteri,malteri,sætteri,elementbyggeri,hjemmebrænderi,regelrytteri,billedlotteri,marketenderi,klamphuggeri,smøreri,kæleri,rapseri,betleri,dampvaskeri,natteroderi,marineinfanteri,pilleri,freskomaleri,rovfiskeri,luskeri,galanteri,tøjeri,lefleri,brænderi,kujoneri,kævleri,kværulanteri,optrækkeri,miniaturemaleri,bijouteri,pindehuggeri,svindleri,lodseri,sejpineri,søvngængeri,bigotteri,paragrafrytteri,piratfiskeri,klatmaleri,skaberi,løsgængeri,epigoneri,garnfiskeri,risteri,færgeri,strikkeri,rejefiskeri,trawlfiskeri,kalkbrænderi,snerperi,kogleri,tuderi,fritænkeri,snurrepiberi,blomstergartneri,anegalleri,genremaleri,skomageri,virtuoseri,stenhuggeri,sukkerraffinaderi,gnideri,liberi,startbatteri,tørreri,trolderi,sliberi,montagebyggeri,kogeri,dødbideri,djævleri,skrankepaveri,silderøgeri,kradseri,skruebrækkeri,fasaneri,ordgyderi,tallotteri,privateri,spytslikkeri,knirkeri,bengnaveri,selvbyggeri,slikkeri,provencekrydderi,taskenspilleri,typegalleri,hjemmebageri,afguderi,gnaveri,skælmeri,japperi,trommesalsmaleri,drøvtyggeri,stikleri,solderi,fribytteri,skulkeri,rebslageri,partrederi,brasseri,sofisteri,ferskvandsfiskeri,charlataneri,driveri,stenfiskeri,kissemisseri,rethaveri,kniberi,træskæreri,krakileri,skumleri,checkrytteri,lumskeri,monumentalmaleri,gobelinvæveri,vrøvleri,glassliberi,flerguderi,bæltfiskeri,gnieri,jageri,jobberi,plafondmaleri,klatteri,vekselrytteri,teglbrænderi,smelteri,rabulisteri,put and take-fiskeri,pandekageri,valkeri,strygeri,hårkløveri,våseri,skrædderi,anderi,drejeri,kondomeri,binderi,gobelinbroderi,solbatteri,trusserederi,gørtleri,krybfiskeri,hærderi,overløberi,rotisseri,skriftstøberi,krogfiskeri,sjaskeri,buntmageri,klimpreri,vindmageri,linefiskeri,bizarreri,saddelmageri,pimperi,posekiggeri,nikkel-cadmium-batteri,kontoriusseri,fusentasteri,fidusmaleri,salteri,skylleri,gæsteri,litiumionbatteri,smigreri,spindefiskeri,sejtrækkeri,jaskeri,vodbinderi,filisteri,æreskænderi,skidteri
3	son	31	0.00055	30	1	person,sæson,hovedperson,enkeltperson,privatperson,højsæson,forsøgsperson,kontaktperson,nøgleperson,fagperson,biperson,testperson,talsperson,ræson,garnison,bison,lavsæson,interviewperson,jagtsæson,titelperson,mandsperson,støtteperson,transperson,chanson,nelson,standsperson,forperson,ankerperson,blouson,attentionperson	kortison
3	ald	74	0.00055	7	67	stald,knald,hestestald,skjald,sukkerknald,tjald,augiasstald	fald,affald,dødsfald,udfald,overfald,kald,opkald,forfald,prisfald,kursfald,bifald,afkald,knald,skrald,anfald,vandfald,frafald,indfald,sammenfald,tonefald,telefonopkald,tilbagefald,knæfald,udkald,atomaffald,bortfald,syndefald,snefald,lysindfald,angstanfald,raserianfald,storskrald,tæppefald,nødkald,bundfald,tiltalefrafald,nedfald,nødopkald,mandefald,løvfald,kemikalieaffald,krampeanfald,tordenskrald,hosteanfald,stormfald,møgfald,henfald,giftaffald,nødsfald,præstekald,messefald,rullefald,tilkald,solindfald,ejefald,mørkefald,hjald,fremfald,klinkefald,underfald,nævnefald,genstandsfald,hensynsfald,jordfald,afhængighedsfald,gjald,solfald
3	ris	79	0.00054	73	6	pris,kris,gris,huspris,litteraturpris,salgspris,overpris,hæderspris,forbrugerpris,benzinpris,merpris,iris,udsalgspris,købspris,normalpris,lavpris,kilopris,mindstepris,sparegris,listepris,pattegris,spotpris,klitoris,indkøbspris,hybris,kostpris,specialpris,jordpris,nypris,tilbudspris,stykpris,kontantpris,mosegris,vurderingspris,dagspris,kuvertpris,frilandsgris,literpris,brugtpris,maksimalpris,favørpris,tøris,gyldenris,marcipangris,fremstillingspris,førpris,basmatiris,detailpris,underpris,bundpris,ærenpris,nyvognspris,grødris,vennepris,cirkapris,berberis,storis,fastpris,apollinaris,mestergris,singularis,smågris,iberis,nupris,højsæsonpris,øfgris,leveringspris,Nobelpris,snitpris,gråris,angina pectoris,tærskelpris,højestepris	piskeris,fastelavnsris,vris,enebærris,ekslibris,castrum doloris
3	lie	62	0.00054	55	7	familie,olie,børnefamilie,olivenolie,kongefamilie,plejefamilie,kernefamilie,råolie,repressalie,dieselolie,folie,fyringsolie,storfamilie,rapsolie,fiskeolie,småbørnsfamilie,alufolie,svigerfamilie,linolie,collie,jomfruolivenolie,konkylie,smøreolie,spildolie,aflastningsfamilie,fuelolie,kaprifolie,solsikkeolie,sololie,spiseolie,gasolie,regnbuefamilie,sojaolie,jomfruolie,bioolie,brændselsolie,hydraulikolie,paraffinolie,rosenolie,salatolie,skæreolie,støttefamilie,flerbørnsfamilie,fuselolie,kalmusolie,vigilie,kommenolie,bergamotolie,ricinusolie,aralie,terpentinolie,harpiksolie,nellikeolie,homilie,kamferolie	kemikalie,folie,alufolie,ganglie,evangelie,juleevangelie,utensilie
3	mål	68	0.00054	0	68		spørgsmål,formål,slagsmål,lejemål,gøremål,modersmål,selvmål,sejrsmål,søgsmål,væddemål,skudsmål,giftermål,endemål,udflugtsmål,delmål,overmål,klimamål,metermål,lavmål,mindstemål,hundeslagsmål,topmål,tungemål,gruppesøgsmål,tvivlsspørgsmål,masseslagsmål,åremål,stridsspørgsmål,skriftemål,trinmål,værgemål,skyldspørgsmål,øjemål,livsmål,rigsmål,versemål,detailspørgsmål,bokmål,kæremål,læringsmål,styrkemål,rummål,centimetermål,tværmål,litermål,skændsmål,principspørgsmål,klagemål,verdensmål,livmål,trickspørgsmål,tidsspørgsmål,flademål,landsmål,etmål,kardinalspørgsmål,folkemål,decilitermål,undermål,stregmål,kopmål,jævnmål,tvistemål,kragemål,udråbsspørgsmål,venusmål,båndmål,tøndemål
3	lle	217	0.00053	212	5	rolle,hovedrolle,mølle,celle,ægtefælle,vindmølle,brille,pille,partifælle,novelle,bolle,persille,promille,rulle,frikadelle,kølle,solcelle,balle,jolle,gylle,birolle,bølle,krølle,krokodille,titelrolle,kønsrolle,helle,stamcelle,bille,mulle,skalle,lykkepille,palle,køkkenrulle,skideballe,rille,trille,nøglerolle,sædcelle,artsfælle,dille,fælle,filmrolle,forbundsfælle,delle,brændselscelle,fagfælle,meningsfælle,flødebolle,vitaminpille,stikpille,trosfælle,tælle,dulle,golfkølle,sovepille,valle,malle,fiskefrikadelle,terrorcelle,kasserolle,ratatouille,forårsrulle,bandbulle,eskadrille,fastelavnsbolle,havmølle,galle,kampfælle,kødbolle,gazelle,lammekølle,skylle,bofælle,manderolle,kamille,bropille,bacille,krusedulle,trædemølle,gælle,svikmølle,optimistjolle,kagerulle,glansrolle,fodboldbølle,helterolle,svelle,vaudeville,vejrmølle,grovbolle,filmrulle,fartbølle,fortrydelsespille,grille,finnjolle,kønsfælle,ægcelle,nervepille,modedille,stolle,hornbrille,isolationscelle,flotille,sibylle,karakterrolle,støttepille,fedtcelle,oliemølle,falle,enecelle,slangekrølle,pølle,malerrulle,solbrille,melbolle,fotocelle,frille,borebille,kvadrille,fiskebolle,kruspersille,våbenfælle,læsebrille,dyrekølle,smørbolle,negerbolle,krydderbolle,bulle,snudebille,tagliatelle,dødscelle,pulle,stubmølle,bedemølle,chokoladebolle,kartebolle,løbebille,barkbille,nilkrokodille,munkecelle,coloradobille,tylle,punchebolle,sesambolle,torarulle,mandsrolle,chenille,bærepille,tordenskylle,regnskylle,strafcelle,brændstofcelle,rosinbolle,stræbepille,fiskerjolle,snebolle,klostercelle,piratjolle,motorbølle,næsehornsbille,mosebølle,rådyrkølle,reveille,spytkrølle,grundskyldpromille,brunelle,minipille,titaniumbrille,gødningsbille,krudtmølle,libelle,espadrille,langskalle,kortskalle,kragejolle,strygerulle,fontanelle,dådyrkølle,bombarderbille,elskerrolle,husfælle,durumrulle,trådrulle,kokosbolle,rudskalle,tulle,kochenille,pavebulle,stampemølle,walesbolle,hækjolle,kokille,cedille,rissolle,pimpinelle,lastpalle,focacciabolle,præventivpille,fnugrulle,praltrille,hørebrille,p-pille,OK-jolle,grønpille,brødbille,nonpareille,ådselbille,svømmebrille,kardinalbille,køllebille,tvetulle	helle,skille,oldekolle,stille,vindstille
3	ord	150	0.00052	36	114	jord,rekord,fjord,verdensrekord,lord,landjord,akkord,bundrekord,krydsord,muldjord,lerjord,sandjord,markjord,publikumsrekord,agerjord,hjord,tvangsakkord,marginaljord,gjord,råjord,grundakkord,inderfjord,slutakkord,frijord,pløjejord,molakkord,fyldjord,grønjord,podsoljord,whipcord,porcelænsjord,buggjord,valkejord,fædrenejord,klægjord,brunjord	bord,mord,selvmord,skrivebord,mindeord,forord,folkemord,forhandlingsbord,spisebord,nøgleord,slagord,køkkenbord,kodeord,skældsord,kaffebord,middagsbord,sofabord,massemord,morgenbord,stikord,bandeord,fremmedord,operationsbord,lovord,langbord,password,arbejdsbord,tillægsord,karaktermord,natbord,justitsmord,ukvemsord,navneord,tegnebord,efterord,krydsord,søgeord,plusord,udsagnsord,buzzword,stambord,lejemord,rovmord,låneord,visdomsord,fyord,snigmord,spillebord,puslebord,fyndord,højbord,barnemord,sengebord,rullebord,stedord,alvorsord,klapbord,klippebord,konferencebord,seriemord,forholdsord,biord,enstavelsesord,slangord,fribord,tebord,bakkebord,lydord,toiletbord,salatbord,æresord,staveord,sminkebord,hånsord,knivmord,anretterbord,småord,fyldord,clearingmord,konsolbord,aftensbord,talord,lysbord,bindeord,fagord,ritualmord,lystmord,udråbsord,kendeord,tabuord,minusord,pendulord,rimord,intetkønsord,ejestedord,stigbord,livord,tostavelsesord,hjælpeudsagnsord,hæve-sænke-bord,vaterbord,initialord,trendbord,mådesudsagnsord,tiltaleord,tag selv-bord,målebord,arveord,flerstavelsesord,varmebord,gradsbiord,noaord,mådesbiord,stedsbiord
3	sel	166	0.00052	136	30	trussel,efterspørgsel,advarsel,fødsel,kørsel,opførsel,diesel,længsel,trivsel,rædsel,trængsel,barsel,forespørgsel,overførsel,indkørsel,rundkørsel,pensel,spirituskørsel,glemsel,dødstrussel,spritkørsel,karrusel,påkørsel,kapsel,tilførsel,afkørsel,veksel,nedkørsel,færdsel,genfødsel,skændsel,syssel,indførsel,udlængsel,udkørsel,pinsel,aksel,pengeoverførsel,skærmydsel,tidsel,blusel,hassel,testkørsel,bagaksel,frakørsel,bykørsel,prøvekørsel,overkørsel,gennemkørsel,bombetrussel,tilkørsel,knastaksel,barnefødsel,omkørsel,udførsel,mejsel,samkørsel,brissel,tilbageførsel,opkørsel,jomfrufødsel,promillekørsel,rumkapsel,gennemførsel,vanvidskørsel,tidskapsel,dødskørsel,motorvejskørsel,drossel,dataoverførsel,venstrekørsel,hjulkapsel,frøkapsel,hjemmefødsel,bortførsel,samfærdsel,højrekørsel,ølkapsel,skånsel,væsel,kisel,hjemlængsel,genindførsel,dødfødsel,kardanaksel,drivaksel,studenterkørsel,malerpensel,personpåkørsel,slalomkørsel,anførsel,vantrivsel,krumtapaksel,meritoverførsel,fritidssyssel,smitteoverførsel,sangdrossel,bortkørsel,fremførsel,vindrossel,vidneførsel,kortegekørsel,ærindekørsel,ransel,skrueaksel,sædefødsel,hjulaksel,mausel,fusel,misteldrossel,efterfødsel,rapunsel,valmuekapsel,agertidsel,vognaksel,tyngsel,sigtveksel,rådførsel,rataksel,spilaksel,marietidsel,solaveksel,pendulkørsel,sekundaveksel,ilandkørsel,krankaksel,excenteraksel,a vista-veksel,punsel,underkørsel,glatkørsel,brøndsel,datoveksel,hjemførsel,retouchepensel,primaveksel	fængsel,gidsel,varsel,statsfængsel,brændsel,varetægtsfængsel,æsel,biobrændsel,syssel,forvarsel,hængsel,dæksel,ådsel,fugleskræmsel,strejkevarsel,isolationsfængsel,gældsfængsel,stormvarsel,bidsel,pakæsel,kloakdæksel,skræmsel,benzindæksel,surrogatfængsel,mulæsel,bindsel,vindsel,urovarsel,stævnevarsel,dørhængsel
3	nkt	52	0.00051	2	50	adjunkt,seminarieadjunkt	tidspunkt,udgangspunkt,punkt,synspunkt,højdepunkt,omdrejningspunkt,standpunkt,vendepunkt,midtpunkt,lyspunkt,instinkt,samlingspunkt,brændpunkt,knudepunkt,kritikpunkt,bristepunkt,lavpunkt,holdepunkt,hovedpunkt,nulpunkt,frysepunkt,tyngdepunkt,yderpunkt,kogepunkt,anklagepunkt,fikspunkt,kardinalpunkt,kontrapunkt,toppunkt,klagepunkt,smertepunkt,støttepunkt,mætningspunkt,træfpunkt,mødetidspunkt,sendetidspunkt,angrebspunkt,smeltepunkt,urinstinkt,sigtepunkt,berøringspunkt,moderinstinkt,ankepunkt,dugpunkt,orgelpunkt,flokinstinkt,flammepunkt,dødpunkt,g-punkt,tvistepunkt
3	ift	159	0.00051	118	41	udgift,drift,afgift,overskrift,opskrift,stift,skrift,bedrift,underskrift,gift,fremdrift,lift,rift,renteudgift,sprøjtegift,forskrift,håndskrift,døgndrift,tilgift,læbestift,togdrift,påskrift,voldgift,efterskrift,minedrift,udskrift,rovdrift,miljøafgift,vægtafgift,indskrift,kørselsafgift,modgift,stordrift,arveafgift,facelift,opdrift,afskrift,medgift,punktafgift,transportudgift,landbrugsdrift,miljøgift,gaveafgift,stempelafgift,boafgift,gravskrift,dødsdrift,rottegift,tegnestift,kønsdrift,skilift,seksualdrift,samdrift,selvopholdelsesdrift,studieafgift,kontrolafgift,skråskrift,båndudskrift,domsudskrift,importafgift,kontoudskrift,kileskrift,blindskrift,runeindskrift,indgift,underoverskrift,kontinentaldrift,lydskrift,limstift,punktskrift,løsdrift,kapiteloverskrift,halvtimesdrift,cellegift,skønskrift,omsætningsafgift,babylift,formskrift,enkeltudgift,omdrift,afdrift,vekseldrift,rusgift,blindeskrift,grundafgift,slagstift,værdiafgift,merværdiafgift,forgift,nedskrift,kodeskrift,renskrift,skriveskrift,billedskrift,spejlskrift,brødskrift,deodorantstift,ildskrift,blokskrift,sansserifskrift,reliefskrift,kursivskrift,timinuttersdrift,pilegift,p-afgift,printerudskrift,brailleskrift,versalskrift,tyveminuttersdrift,hieroglyfskrift,garderobeafgift,CO₂-afgift,tegnskrift,chifferskrift,klarskrift,stejlskrift,petitskrift,totimersdrift	skift,tidsskrift,stift,skrift,anklageskrift,lift,håndskrift,ugeskrift,pift,efterskrift,udskrift,gearskift,paradigmeskift,festskrift,sceneskift,navneskift,stilskift,temposkift,holdningsskift,bleskift,stemningsskift,karriereskift,skoleskift,treholdsskift,båndudskrift,domsudskrift,smædeskrift,svarskrift,kontoudskrift,kildeskrift,olieskift,vift,månedsskrift,klageskrift,toholdsskift,linjeskift,hjulskift,lægeskift,treskift,printerudskrift,omskift
3	øde	57	0.00051	20	37	jøde,bøde,afgrøde,føde,fløde,bløde,piskefløde,grøde,brøde,fartbøde,dummebøde,helligbrøde,kanonføde,morgenrøde,energiafgrøde,efterafgrøde,planteføde,aftenrøde,førstegrøde,dagbøde	møde,topmøde,pressemøde,årsmøde,retsmøde,borgermøde,fremmøde,folkemøde,vælgermøde,stormøde,ministermøde,forældremøde,orienteringsmøde,skøde,stævnemøde,rådsmøde,delegeretmøde,hastemøde,redaktionsmøde,telefonmøde,frokostmøde,bønnemøde,formøde,friluftsmøde,plenarmøde,introduktionsmøde,infomøde,videomøde,lærermøde,rigsmøde,heldagsmøde,summemøde,plenummøde,todagesmøde,gå hjem-møde,flerdagesmøde,internatmøde
3	ppe	115	0.00050	89	26	gruppe,trappe,suppe,målgruppe,klippe,aldersgruppe,hoppe,slippe,styregruppe,mappe,terrorgruppe,kappe,vippe,loppe,kontrolgruppe,risikogruppe,kundegruppe,steppe,interessegruppe,følgegruppe,græshoppe,kontaktgruppe,rulletrappe,fokusgruppe,restgruppe,iskappe,mødregruppe,øjenvippe,undergruppe,puppe,socialgruppe,lavindkomstgruppe,moppe,skæppe,pigegruppe,bagtrappe,vindeltrappe,nyhedsgruppe,hovedtrappe,sneppe,tomatsuppe,sødsuppe,referencegruppe,ærtesuppe,køkkentrappe,løgsuppe,knippelsuppe,skræppe,højrisikogruppe,drengegruppe,brandtrappe,tangloppe,dokumentmappe,aspargessuppe,marginalgruppe,vennegruppe,attachémappe,landegruppe,backinggruppe,skovsneppe,fisketrappe,messingsuppe,fædregruppe,hælkappe,slængkappe,samlemappe,kobbersneppe,græssteppe,fortrappe,sippe,skildpaddesuppe,musetrappe,spindeltrappe,legegruppe,erfagruppe,følhoppe,oksehalesuppe,kørvelsuppe,kråsesuppe,noppe,timetervippe,xanthippe,gardinkappe,lavstatusgruppe,snippe,femmetervippe,højstatusgruppe,juliennesuppe,gulvmoppe	tæppe,gulvtæppe,jerntæppe,bagtæppe,kludetæppe,sengetæppe,billedtæppe,vægtæppe,vattæppe,fortæppe,bedetæppe,slumretæppe,ryatæppe,kelimtæppe,nøgleknippe,knippe,brandtæppe,kokostæppe,hyrdetæppe,halmknippe,axminstertæppe,vendetæppe,væg til væg-tæppe,berbertæppe,wiltontæppe,duntæppe
3	est	94	0.00049	93	1	rest,fest,hest,protest,test,vest,hyldest,arrest,pest,straffeattest,byfest,husarrest,nordvest,incest,folkefest,sydvest,redningsvest,asbest,kæphest,fyldest,dåbsattest,attest,flodhest,travhest,tingest,jubilæumsfest,klassefest,madrest,gadefest,crashtest,skolefest,svinepest,arbejdshest,gest,havefest,læsehest,dødsattest,gallafest,fødselsattest,afslutningsfest,søhest,ridehest,efterfest,gentest,gyngehest,sejrsfest,stuearrest,vielsesattest,lægeattest,trækhest,blindtest,kindhest,fuldblodshest,palimpsest,bryggerhest,araberhest,yndest,svømmevest,abefest,forfest,helbredsattest,priktest,synstest,frederiksborghest,helhest,stortest,kvægpest,vandpest,indflytterfest,allergitest,sengehest,navneattest,glædesfest,racehest,energiattest,pruhest,skægpest,leveattest,toldattest,kandidatfest,psykotest,hyphest,doubletest,høretest,lappetest,vagtarrest,tripeltest,halvblodshest,tinpest,kvarterarrest,syrerest,rusfest,smeartest	manifest
3	ten	93	0.00049	89	4	aften,sten,juleaften,mursten,nytårsaften,skorsten,brosten,gravsten,grundsten,hjørnesten,fyraften,hovedrysten,kantsten,tagsten,mindesten,byggesten,ædelsten,rendesten,runesten,teglsten,sankthansaften,sandsten,kampesten,mistelten,kalksten,trappesten,rullesten,prøvesten,anstødssten,trædesten,hovedhjørnesten,møllesten,nyresten,øjesten,galdesten,helligtrekongersaften,mortensaften,flintesten,friaften,hinkesten,munkesten,smykkesten,fedtsten,slutsten,slibesten,kirsebærsten,bautasten,tandsten,vinsten,månesten,drypsten,pimpsten,chaussésten,rhinsten,rokkesten,limsten,kvadersten,brunsten,facadesten,kværnsten,hvæssesten,håndten,tungsten,magnetjernsten,frådsten,blåsten,kedelsten,pizzasten,gulsten,smutsten,klæbersten,skelsten,trykseksten,formsten,påskeøsten,piksten,brunjernsten,storebededagsaften,valborgaften,ranglesten,helvedessten,kragsten,afvisersten,lasursten,faconsten,lille juleaften,spæksten,vegsten,pusten	vesten,østen,gluten,trykseksten
3	kel	153	0.00049	139	14	forskel,artikel,cykel,vinkel,motorcykel,muskel,onkel,cirkel,synsvinkel,matrikel,partikel,ankel,fakkel,tærskel,floskel,sokkel,stakkel,pukkel,indfaldsvinkel,bycykel,fennikel,testikel,racercykel,knokkel,polarcirkel,kakkel,dørtærskel,kondicykel,lattermuskel,mavemuskel,motionscykel,halvcirkel,damecykel,snorkel,elcykel,ladcykel,lægmuskel,kameravinkel,temperaturforskel,indercirkel,morkel,herrecykel,kontinentalsokkel,elementarpartikel,skinnecykel,eksportartikel,målforskel,ventrikel,smertetærskel,tolerancetærskel,grandonkel,vandcykel,ranunkel,benmuskel,tentakel,vidvinkel,legeonkel,armmuskel,budcykel,gradsforskel,toiletartikel,angrebsvinkel,monokel,trosartikel,lukkemuskel,antipartikel,snirkel,væsensforskel,fastlandssokkel,aurikel,ringmuskel,tandemcykel,standsforskel,bitestikel,foldecykel,pumpernikkel,kernepartikel,schenkel,vikkel,løbecykel,kluddermikkel,halvcykel,alfapartikel,granitsokkel,barnecykel,skvatmikkel,sjækkel,follikel,hulkel,svinemikkel,minicykel,turcykel,snørkel,bukkel,turistcykel,minuskel,tricykel,skinkel,storcirkel,udfaldsvinkel,vandranunkel,majuskel,arveonkel,ergometercykel,bugmuskel,havefakkel,tuberkel,svikkel,spidsartikel,hybridcykel,jøkel,halvonkel,rygmuskel,artsforskel,bøjemuskel,perpendikel,fascikel,komplementvinkel,BMX-cykel,centervinkel,tenakel,klubcykel,betapartikel,valutapukkel,rangforskel,konventikel,eksplementvinkel,topvinkel,våsemikkel,ægvinkel,sjuskemikkel,sanikel,karfunkel,hemicykel,strækkemuskel,somikkel,nabovinkel,smigvinkel,tudemikkel	mirakel,skel,orakel,spektakel,nikkel,klasseskel,sekel,tabernakel,markskel,vandskel,husspektakel,vehikel,grænseskel,kobbernikkel
3	orm	85	0.00049	85	0	form,reform,storm,norm,platform,skattereform,uniform,kommunalreform,topform,styreform,snestorm,folkeskolereform,gymnasiereform,regnorm,storform,boreplatform,mediestorm,kampform,boform,dagsform,hugorm,pasform,værdinorm,skoleuniform,bogorm,springform,politiuniform,støbeform,sandstorm,brainstorm,telefonstorm,shitstorm,bændelorm,landboreform,kortform,sandorm,bageform,kanonform,lindorm,melorm,pulverform,gallauniform,blandingsform,rundorm,børsteorm,silkeorm,kålorm,blandform,tillægsform,bøjningsform,brandstorm,hudorm,kageform,kloroform,pæleorm,støvstorm,indvoldsorm,staveform,fladorm,tilstandsform,børneorm,solstorm,bydeform,seerstorm,hesteskoform,stålorm,ringorm,væskeform,sankthansorm,navneform,handleform,lovform,generalsuniform,østenstorm,spoleorm,trådorm,lideform,kaptajnsuniform,kummerform,vestenstorm,opslagsform,præsensform,tempusform,jodoform,hjernestorm	
3	ede	83	0.00048	36	47	vrede,bede,rede,hede,rødbede,hvede,lede,skede,vildrede,politikerlede,fuglerede,mede,hvepserede,rotterede,livslede,boghvede,sølvbede,svalerede,elskovsrede,durumhvede,vindskede,selvlede,ølandshvede,vejvrede,velocipede,røverrede,seneskede,lummerhede,alhede,kragerede,samojede,urede,kohvede,moderskede,gøgerede,steghede	billede,helvede,forbillede,embede,verdensbillede,bybillede,lydbillede,fjendebillede,skræmmebillede,spejlbillede,nærbillede,glansbillede,vildrede,tidsbillede,røntgenbillede,lysbillede,sindbillede,selvbillede,nøgenbillede,stjernebillede,skærmbillede,modbillede,idealbillede,stillbillede,gruppebillede,profilbillede,vrangbillede,smertehelvede,gudebillede,skyggebillede,klassebillede,støjhelvede,ordbillede,helgenbillede,vrængbillede,prøvebillede,genrebillede,fantasibillede,fantombillede,skriftbillede,fikserbillede,brystbillede,gøglebillede,satsbillede,urede,boudoirbillede,genbillede
3	ærk	93	0.00048	5	88	værk,lærk,bersærk,særk,kværk	værk,netværk,hærværk,kunstværk,håndværk,kraftværk,mesterværk,vandværk,atomkraftværk,kunsthåndværk,gasværk,bygningsværk,livsværk,embedsværk,elværk,vokseværk,teglværk,træværk,murværk,bolværk,varmeværk,plankeværk,hastværk,savværk,årsværk,underværk,makværk,fjernvarmeværk,rækværk,storværk,bindingsværk,bagværk,glasværk,stålvalseværk,dagsværk,stålværk,tovværk,korværk,blændværk,urværk,fæstningsværk,fletværk,pragtværk,standardværk,tobindsværk,elektricitetsværk,pelsværk,billedværk,udenværk,bygværk,hejseværk,gitterværk,tærskeværk,digterværk,isværk,galmandsværk,samleværk,regelværk,stokværk,narreværk,kalkværk,stemmeværk,gætteværk,tælleværk,bjergværk,drivværk,valseværk,bygningshåndværk,løvværk,tagværk,slagværk,sluseværk,åndsværk,tømmerværk,bjælkeværk,kraft-varme-værk,trådværk,pindeværk,ristværk,gråværk,legeværk,trisseværk,hæmværk,knuseværk,tømrerhåndværk,slyngværk,a-kraftværk,sprinkelværk
3	var	28	0.00047	7	21	arkivar,pighvar,rigsantikvar,rigsarkivar,antikvar,slethvar,samovar	ansvar,svar,forsvar,medansvar,immunforsvar,virvar,midterforsvar,selvforsvar,hovedansvar,modsvar,civilforsvar,ledelsesansvar,titelforsvar,strafansvar,gensvar,produktansvar,autosvar,automatsvar,tilsvar,medieansvar,samsvar
3	rti	23	0.00046	2	21	inerti,havarti	parti,årti,kommunistparti,støtteparti,arbejderparti,midterparti,søsterparti,protestparti,hængeparti,bagparti,ungdomsparti,japarti,soloparti,forparti,udbryderparti,restparti,nejparti,bækkenparti,broderparti,agterparti,fornuftsparti
3	ked	23	0.00046	4	19	besked,afsked,talebesked,SMS-besked	marked,arbejdsmarked,supermarked,boligmarked,loppemarked,verdensmarked,hjemmemarked,byggemarked,kræmmermarked,kapitalmarked,pengemarked,lånemarked,fællesmarked,eftermarked,gedemarked,madmarked,minimarked,spotmarked,stumpemarked
3	rer	186	0.00045	186	0	lærer,indvandrer,ordfører,oprører,forsvarer,topscorer,kører,fører,tilhører,anfører,skolelærer,tømrer,gymnasielærer,folkeskolelærer,målscorer,irer,kasserer,udfordrer,murer,forretningsfører,ungarer,klasselærer,svarer,bærer,syrer,eventyrer,hører,overlærer,bestyrer,landsretssagfører,ordstyrer,beundrer,kørelærer,telefonsvarer,sagfører,bannerfører,dansklærer,knallertkører,spilfører,erobrer,andengenerationsindvandrer,bulgarer,faglærer,værkfører,grosserer,skibsfører,vandrer,midterforsvarer,forfører,fyrrer,matematiklærer,togfører,lokofører,bortfører,udvandrer,hærfører,nordirer,klatrer,idrætslærer,hundefører,gæstelærer,vandbærer,korsfarer,bobestyrer,frimurer,maurer,velgører,højesteretssagfører,kranfører,hårtørrer,fanebærer,kurer,dukkefører,timelærer,bagagebærer,firer,småsparer,vekselerer,kulturbærer,flykaprer,testkører,sproglærer,fysiklærer,skildrer,smittebærer,tysklærer,søfarer,kaprer,gymnastiklærer,rejsefører,truckfører,sparer,comorer,institutbestyrer,møbelpolstrer,sidegadevekselerer,rallykører,huslærer,førstelærer,ungdomsoprører,blødgører,arrestforvarer,traktorfører,assyrer,autolakerer,hjælpelærer,billedskærer,bayrer,filialbestyrer,gruppefører,lurer,sløjdlærer,bådfører,skibstømrer,spilstyrer,fondsbørsvekselerer,styrer,støttelærer,vognstyrer,træskærer,nattevandrer,føntørrer,fredsforstyrrer,førstegenerationsindvandrer,besejrer,kontaktlærer,kantinebestyrer,indvandrerlærer,regnelærer,titelforsvarer,cimbrer,tilskærer,elektrofører,sorterer,sumerer,qatarer,spillelærer,dorer,zairer,hoffourer,vinduespolerer,ligbærer,holdfører,fremmedfører,tapetserer,talelærer,iberer,meritlærer,brødskærer,myanmarer,gaffeltruckfører,praktiklærer,mobilsvarer,døvelærer,støvbærer,glasskærer,lakerer,promillekører,efterplaprer,tilvandrer,smigrer,ostindiefarer,undergører,skrivelærer,polerer,osteskærer,polstrer,italiensfarer,fourer,skadegører,chartrer,nigerer,smører,hamstrer,toldklarerer,tale-høre-lærer,forskærer,pileborer,nordpolsfarer,brøndborer,klovbeskærer,raderer,smitteopsporer,tatoverer,rambukfører,modellerer	
3	ode	61	0.00044	55	6	periode,metode,episode,mode,klode,gode,kode,valgperiode,node,pode,skudepisode,jordklode,regeringsperiode,kommode,elektrode,kustode,stregkode,unode,pinkode,rode,prøveperiode,diode,dresscode,lysdiode,pagode,glansperiode,overenskomstperiode,synode,slagtemetode,undersøgelsesmetode,salamimetode,grønthøstermetode,kildekode,naturmetode,kuldeperiode,stokkemetode,downperiode,tiårsperiode,katode,antipode,koldkrigsperiode,anode,jammerkommode,gulerodsmetode,rapsode,halvnode,helnode,log-on-kode,mund til næse-metode,unisexmode,teenagemode,interimsperiode,gør det selv-metode,mund til mund-metode,glaselektrode	gode,forbrugsgode,frynsegode,personalegode,landemode,frihedsgode
3	igt	63	0.00044	42	21	udsigt,sigt,pligt,hensigt,indsigt,opsigt,oversigt,aktindsigt,værnepligt,tavshedspligt,vejrudsigt,fremtidsudsigt,gigt,slidgigt,havudsigt,vigepligt,leddegigt,selvindsigt,skattepligt,bopælspligt,undervisningspligt,borgerpligt,mødepligt,døgenigt,tilbudspligt,skolepligt,visumpligt,vidnepligt,afbigt,anmeldelsespligt,tjenestepligt,fredspligt,bidragspligt,gerigt,højrevigepligt,hilsepligt,anmeldepligt,bihensigt,besigt,dørgerigt,værtspligt,underholdspligt	ansigt,digt,svigt,omsorgssvigt,strømsvigt,nyresvigt,hjertesvigt,stenansigt,prosadigt,haikudigt,blegansigt,leversvigt,gummiansigt,barneansigt,smædedigt,bremsesvigt,pokeransigt,eddadigt,opdigt,endeligt,fuldmåneansigt
3	ant	181	0.00044	171	10	restaurant,repræsentant,kant,demonstrant,variant,elefant,udkant,gigant,diamant,debutant,trafikant,garant,immigrant,tillidsrepræsentant,migrant,fabrikant,trekant,oberstløjtnant,suppleant,pendant,blyant,pant,forkant,spekulant,løjtnant,praktikant,prædikant,firkant,protestant,kommandant,underkant,overkant,vejkant,vandkant,kontrollant,aspirant,brillant,laborant,kombattant,emigrant,generalløjtnant,venstrekant,strandkant,premierløjtnant,højrekant,dilettant,sikkerhedsrepræsentant,antioxidant,fiskerestaurant,musikant,grøftekant,deodorant,croissant,mutant,yderkant,informant,proviant,kværulant,ignorant,borgerrepræsentant,bagkant,sekundant,arrestant,konsonant,adjudant,duellant,gratulant,tant,diskant,drabant,konstant,passant,adoptant,kaptajnløjtnant,arbejdsmiljørepræsentant,farveblyant,boligspekulant,registrant,hospitalslaborant,vækkelsesprædikant,hadprædikant,pedant,fortovsrestaurant,sekondløjtnant,advarselstrekant,dansant,erhvervspraktikant,fedtkant,dominant,figurant,slant,søelefant,komediant,lægprædikant,intendant,observant,kvadrant,asylant,femkant,ribkant,fondant,sekskant,infant,flyverløjtnant,kvant,fabulant,sekstant,flaskepant,flagellant,gårdmusikant,blondekant,cremant,determinant,ottekant,simulant,ascendant,volant,foliant,okkupant,warrant,tegneblyant,aktant,antiperspirant,restant,amarant,krokant,håndkant,techgigant,mandant,nonkombattant,kommunikant,invariant,sekant,ægkant,kohlblyant,priskurant,skrueblyant,tungekant,participant,grundspekulant,subdominant,histolaborant,skråkant,vankant,hospitant,optant,reflektant,hældekant,ministrant,appellant,vagant,hydrant,vindikant,ordinant,resultant,kapitulant,plusvariant,clairvoyant,bonvivant,interpellant,kontokurant,forpraktikant,spirant,tømrerblyant,mangekant,tremulant,dublant,obskurant,sibilant,attestant,prænumerant	pant,vant,tant,spant,fjant,kvant,flaskepant,håndpant,warrant,underpant
3	ilm	36	0.00044	36	0	film,dokumentarfilm,spillefilm,tegnefilm,kortfilm,actionfilm,pornofilm,videofilm,stumfilm,novellefilm,gyserfilm,gangsterfilm,kultfilm,kærlighedsfilm,dukkefilm,farvefilm,smalfilm,skrækfilm,splatterfilm,voldsfilm,horrorfilm,westernfilm,forfilm,talefilm,mikrofilm,helaftensfilm,mainstreamfilm,tonefilm,voksenfilm,råfilm,karatefilm,trickfilm,tre-d-film,C-film,kassettefilm,B-film	
3	kst	37	0.00044	36	1	tekst,vækst,opvækst,takst,kontekst,nulvækst,billedtekst,befolkningstilvækst,undertekst,tilvækst,rulletekst,fremvækst,hårvækst,plantevækst,gevækst,lavvækst,minusvækst,misvækst,skægvækst,brødtekst,dværgvækst,udvækst,fortekst,klartekst,hypertekst,flaptekst,posttakst,knoldvækst,nattakst,klaptekst,speakertekst,genvækst,fuldtekst,sekst,ekstemporaltekst,kapitelstakst	hikst
3	lde	81	0.00041	54	27	kilde,hylde,kulde,fælde,fylde,enevælde,indtægtskilde,lyskilde,galde,brændenælde,tilde,nælde,smittekilde,vælde,skralde,oliekilde,bjælde,boghylde,ælde,turistfælde,dødsfælde,fejlkilde,massefylde,musefælde,vægtfylde,rappenskralde,amagerhylde,støjkilde,balde,følelseskulde,kobjælde,brandfælde,helligkilde,rottefælde,adelsvælde,smækfælde,klangfylde,fåmandsvælde,døvnælde,mælde,smagsfylde,landgilde,råkulde,guldnælde,endebalde,røvbalde,vindfælde,fodbalde,hjælpekilde,varmefylde,blæresmælde,håndbalde,kanebjælde,snilde	tilfælde,gilde,enevælde,fortilfælde,rejsegilde,slagtilfælde,vælde,nødstilfælde,særtilfælde,rivegilde,ulykkestilfælde,tvivlstilfælde,grænsetilfælde,enkelttilfælde,sammenskudsgilde,torskegilde,drikkegilde,andendagsgilde,krebsegilde,førstegangstilfælde,papirvælde,drukgilde,høstgilde,adelsvælde,smittetilfælde,fåmandsvælde,snilde
3	dom	63	0.00041	62	1	sygdom,ejendom,ungdom,barndom,kristendom,fattigdom,fordom,rigdom,alderdom,visdom,dødsdom,kræftsygdom,jødedom,lærdom,spådom,dårligdom,helligdom,børnesygdom,lungesygdom,folkesygdom,behandlingsdom,følgesygdom,infektionssygdom,guddom,kønssygdom,mødom,voldsdom,hudsygdom,trolddom,øjensygdom,sindssygdom,børnelærdom,kursusejendom,erhvervssygdom,virussygdom,manddom,stofskiftesygdom,kredsløbssygdom,trældom,tropesygdom,blødersygdom,kvægsygdom,artsrigdom,mangelsygdom,værdidom,straksdom,straffedom,liebhaverejendom,jomfrudom,detailrigdom,lægedom,dødsformodningsdom,voldgiftsdom,multisygdom,gudsdom,fleretagersejendom,Alzheimers sygdom,Parkinsons sygdom,hjerte-kar-sygdom,løndom,standsfordom,nationalejendom	kondom
3	art	75	0.00041	75	0	start,part,fart,hovedpart,modpart,enkeltstart,kvart,topfart,sæsonstart,stilart,dyreart,anpart,luftfart,størstepart,opstart,søfart,skolestart,skibsfart,overfart,medfart,egenart,forbifart,kampstart,studiestart,kickstart,afart,rumfart,gangart,broderpart,færgefart,gokart,langfart,jordart,pendulfart,valfart,tredjepart,rutefart,toneart,raketfart,bjergart,himmelfart,luftart,tyvstart,rekordfart,halvpart,sandart,sneglefart,nedfart,bakkenbart,standart,koldstart,chokstart,taktart,rundfart,semesterstart,bådfart,genpart,gennemfart,regneart,våbenart,genstart,mundart,regningsart,opart,slædefart,kystfart,dybbjergart,fjerdepart,medpart,kirketoneart,trampfart,koffardifart,knebelsbart,sædart,aktionsart	
3	mme	109	0.00041	85	24	stemme,ramme,stamme,flamme,tromme,klemme,tomme,klumme,tremme,lomme,skramme,blomme,æggeblomme,strafferamme,gemme,krumme,træstamme,sangstemme,tidsramme,baglomme,kardemomme,erhvervsfremme,referenceramme,tidslomme,kumme,bræmme,amme,inderlomme,bukselomme,fortællerstemme,brevstemme,stortromme,gumme,lønramme,tømme,brystlomme,indianerstamme,togstamme,målramme,kugleramme,mandsstemme,klamme,låneramme,solostemme,bongotromme,stikflamme,faldstamme,ratstamme,lilletromme,beløbsramme,tøjklemme,madamme,basstemme,listestemme,buslomme,sveskeblomme,tenorstemme,nejstemme,skifteramme,engblomme,sopranstemme,hæfteklamme,fremme,jastemme,fistelstemme,altstemme,guldblomme,muskatblomme,understemme,forlomme,flomme,cykelklemme,svejseflamme,overstemme,stiklomme,hårklemme,tordenstemme,stentorstemme,kjolelomme,blindramme,katrineblomme,diasramme,tuborgklamme,skrålomme,skæreflamme	komme,omdømme,herredømme,gemme,kongedømme,udkomme,overherredømme,hertugdømme,hæmme,kejserdømme,fyrstedømme,bispedømme,pavedømme,storhertugdømme,præstedømme,sheikdømme,eneherredømme,voldsherredømme,nemme,kurfyrstendømme,storfyrstedømme,enevoldsherredømme,jarledømme,tsardømme
3	hus	114	0.00039	0	114		sygehus,rådhus,sommerhus,forsamlingshus,kongehus,kulturhus,værtshus,klubhus,parcelhus,rækkehus,posthus,højhus,operahus,varehus,koncerthus,drivhus,pakhus,fritidshus,skuespilhus,auktionshus,bryghus,underhus,væksthus,blokhus,aktivitetshus,modehus,arresthus,centralsygehus,stuehus,fælleshus,udhus,feriehus,overhus,mediehus,missionshus,baghus,enfamiliehus,beboerhus,førerhus,korthus,borgerhus,glashus,domhus,typehus,lysthus,dukkehus,hønsehus,legehus,våbenhus,blækhus,kernehus,kræmmerhus,spisehus,gæstehus,helårshus,slagtehus,bondehus,lavprisvarehus,galehus,styrehus,sneglehus,tinghus,tugthus,frysehus,maskinhus,dobbelthus,penalhus,langhus,lavenergihus,stamværtshus,hundehus,bjælkehus,forhus,punkthus,råhus,stamhus,horehus,landhus,vajsenhus,bådehus,fyrstehus,prøvehus,kølehus,etplanshus,skilderhus,gårdhavehus,klyngehus,selvbyggerhus,gavlhus,kædehus,vinkelhus,murermesterhus,tofamiliehus,nulenergihus,huggehus,patricierhus,sporehus,andelshus,atriumhus,terrassehus,toplanshus,toetagershus,medbyggerhus,enetageshus,femetagershus,alhus,p-hus,kranhus,færdighus,elementhus,treetagershus,fireetagershus,flerfamiliehus,firetagershus
3	gel	47	0.00039	39	8	huskeregel,mangel,regel,engel,spilleregel,forholdsregel,tommelfingerregel,stængel,slyngel,triangel,smeltedigel,leveregel,iltmangel,skytsengel,yngel,ærkeengel,bagel,blodmangel,messehagel,vitaminmangel,modforholdsregel,sigel,digel,lakseyngel,mergel,rigel,basunengel,materialemangel,svingel,bengel,retsregel,astragel,råstofmangel,spergel,spærreregel,skudrigel,smergel,tidmangel,culparegel	orgel,flygel,tingeltangel,rektangel,hammondorgel,stueorgel,elorgel,dingeldangel
3	die	42	0.00038	16	26	studie,komedie,tragedie,birdie,stadie,folkekomedie,skolekomedie,caddie,forstudie,indie,roadie,situationskomedie,tragikomedie,casestudie,detailstudie,falde på halen-komedie	medie,studie,klenodie,massemedie,stadie,multimedie,forstudie,podie,drømmestudie,billedmedie,forstadie,selvstudie,casestudie,fjernstudie,detailstudie,ætermedie,stipendie,præsidie,remedie,kandidatstipendie,overpræsidie,puppestadie,kompendie,tidsstudie,konferensstudie,kravlestadie
3	ånd	71	0.00038	25	46	hånd,forhånd,tidsånd,overhånd,baghånd,kyshånd,plageånd,højrehånd,holdånd,korpsånd,skønånd,venstrehånd,jernhånd,sportsånd,mellemhånd,skytsånd,klubånd,underhånd,bankeånd,vinånd,vånd,Helligånd,dødningehånd,fjendehånd,knokkelhånd	bånd,samlebånd,armbånd,bredbånd,smilebånd,videobånd,stemmebånd,kassettebånd,ledbånd,korsbånd,løbebånd,snørebånd,halsbånd,stavnsbånd,transportbånd,målebånd,pandebånd,lydbånd,tungebånd,demobånd,hårbånd,strømpebånd,bindebånd,tøndebånd,råbånd,sognebånd,skråbånd,gummibånd,magnetbånd,farvebånd,gavebånd,klisterbånd,velcrobånd,neglebånd,hanebånd,kantbånd,elastikbånd,slibebånd,isolerbånd,hulbånd,trillebånd,klæbebånd,hosebånd,kodebånd,kapitælbånd,burrebånd
3	pil	97	0.00038	10	87	pupil,strømpil,dartpil,hængepil,papil,grædepil,gråpil,kastepil,dværgpil,poppelpil	spil,udspil,skuespil,samspil,slutspil,computerspil,modspil,puslespil,grundspil,angrebsspil,efterspil,gæstespil,rollespil,festspil,kortspil,indspil,forsvarsspil,opspil,fodboldspil,boldspil,magtspil,sammenspil,brætspil,mellemspil,forspil,dobbeltspil,ordspil,klaverspil,lystspil,kontraspil,guitarspil,klokkespil,kammerspil,radiospil,underspil,skakspil,hasardspil,pyramidespil,pokerspil,krybbespil,hovedspil,hørespil,syngespil,lottospil,klumpspil,skyggespil,medspil,solospil,overspil,rænkespil,maskespil,krigsspil,positionsspil,lotterispil,slagspil,nulsumsspil,mummespil,skrabespil,andespil,fedtspil,singleudspil,minespil,stregspil,arkadespil,sørgespil,komediespil,dukkespil,keglespil,satyrspil,ludospil,strengespil,huskespil,vendespil,bobspil,ankerspil,djævlespil,falskspil,gangspil,ekstemporalspil,pilespil,gøglespil,vovespil,TV-spil,loppespil,memoryspil,rubatospil,damspil
3	ime	33	0.00037	30	3	time,dagtime,stime,nattetime,undervisningstime,lime,primetime,grime,mime,pantomime,mandetime,ulvetime,enetime,centime,skoletime,klokketime,ragtime,fritime,hyrdetime,maksime,fiskestime,overtime,sildestime,deletime,katedertime,strime,kilowatt-time,estime,watt-time,hatecrime	regime,militærregime,terrorregime
3	kat	75	0.00037	58	17	skat,advokat,plakat,statsadvokat,topskat,rigsadvokat,kammeradvokat,ejendomsskat,indkomstskat,marginalskat,kommuneskat,kirkeskat,mærkat,bruttoskat,personskat,politiadvokat,bundskat,sangskat,restskat,formueskat,særskat,muskat,havkat,hankat,kulturskat,generaladvokat,kunstskat,kildeskat,vildkat,statsskat,jordskat,grundskat,huskat,abekat,vejskat,sukat,missekat,lækat,forskudsskat,forbrugsskat,tamkat,marekat,pengekat,sabelkat,dukat,perserkat,kapitalvindingsskat,slutskat,siameserkat,kopskat,giftskat,proportionalskat,punktskat,majkat,angorakat,A-skat,majmånedskat,B-skat	certifikat,prædikat,mærkat,fabrikat,syndikat,patriarkat,halvfabrikat,matriarkat,flycertifikat,silikat,flyvecertifikat,pontifikat,duplikat,præjudikat,kanonikat,falsifikat,aktiecertifikat
3	ser	222	0.00036	221	1	læser,kineser,palæstinenser,danser,kejser,russer,afløser,underviser,bokser,passer,firser,gyser,fryser,portugiser,oplæser,halvfemser,laser,frelser,halvfjerdser,blæser,tuneser,halvtredser,balletdanser,vejviser,libaneser,bruser,solodanser,vietnameser,dyrepasser,fuser,indoneser,browser,waliser,vejlenser,svipser,panser,strisser,esbjergenser,pariser,hviderusser,svendborgenser,viser,koldingenser,nasser,problemknuser,ghaneser,svejser,dybfryser,kummefryser,tankpasser,vinduespudser,fundraiser,nyborgenser,messingblæser,udløser,korrekturlæser,marskandiser,linedanser,forelæser,nepaleser,senegaleser,rundviser,kikser,silkeborgenser,samfundsrevser,tresser,friser,oppasser,tåreperser,preusser,kortlæser,druser,træblæser,viborgenser,krydser,congoleser,sekser,hjerteknuser,gejser,milaneser,fremviser,skopudser,klunser,børnepasser,malteser,fræser,roskildenser,abkhaser,revser,knuser,perser,ferieafløser,telefonpasser,mavedanser,gæsteforelæser,oser,sakser,afpresser,varmeblæser,ripenser,herningenser,pekingeser,papirnusser,røjser,forløser,kirgiser,angelsakser,omviser,purser,dispenser,aalborgenser,kradser,piberenser,håndmikser,misser,hornblæser,beruser,saftpresser,tankelæser,sygepasser,sekundviser,bogenser,problemløser,løjser,faaborgenser,havefræser,køgenser,fyrpasser,pengeafpresser,rystepudser,lurblæser,renser,singaleser,sluser,sportsdanser,stepdanser,selvudløser,frontlæsser,håndbruser,divaneser,mikser,blyantspidser,hjørringenser,cistercienser,tarmrenser,skanderborgenser,hvidløgspresser,aflæser,vardenser,brevpresser,måleraflæser,flaskerenser,siameser,kretenser,rudeknuser,kedelpasser,citronpresser,burgøjser,radrenser,glasblæser,bergenser,parser,sprogrevser,nummerviser,skovser,skærveknuser,athenienser,havkrydser,havanneser,maskinpasser,togoleser,minutviser,kickbokser,nykøbingenser,irokeser,kalundborgenser,flænser,genser,vordingborgenser,sønderborgenser,skabsfryser,neglerenser,husbondafløser,telefonbruser,grenaaenser,hybenkradser,sprogrenser,fordanser,sakskøbingenser,gipser,aflæsser,mariagergenser,ceyloneser,sandblæser,stubbekøbingenser,gaboneser,kombifryser,timeviser,foreviser,lundenser,hjemmehosser,presser,hedtvandsrenser,trøstespiser,damprenser,pibekradser,pleaser,stegenser,elektrosvejser,overspiser,grenaagenser,rudkøbingenser,fråser,asseneser,sporrenser,ringkøbingenser,karteuser,knikser,belaruser,teaser,sanmarineser	panser
3	vis	32	0.00035	21	11	avis,morgenavis,radioavis,ugeavis,levevis,lokalavis,gratisavis,netavis,tabloidavis,formiddagsavis,lydavis,frokostavis,drivis,omnibusavis,landsavis,vægavis,skvis,sensationsavis,nødavis,advis,TV-avis	bevis,eksamensbevis,garantibevis,førerbevis,gældsbevis,tilgodebevis,skatkammerbevis,modbevis,gudsbevis,advis,interimsbevis
3	nge	97	0.00035	95	2	unge,konge,fange,vinge,tunge,lange,lunge,slange,bringe,lounge,klynge,krigsfange,klinge,gynge,flænge,tange,dynge,junge,gænge,orange,straffefange,slynge,rygerlunge,grunge,møllevinge,vange,fugleunge,rødtunge,fuglekonge,gønge,gøgeunge,længe,søtunge,kattekonge,kvælerslange,giftslange,søslange,klapperslange,ulveunge,brandslange,samvittighedsfange,årsunge,havslange,udbryderkonge,flugtfange,skruetvinge,landtange,pytonslange,horeunge,svenskekonge,mælkejunge,ballongynge,teleslynge,savklinge,årpenge,longe,takvinge,melange,udlænge,salatslynge,elverkonge,kobraslange,stenlunge,kaninunge,ekskonge,hoppegynge,judaspenge,svømmevinge,svaneunge,oksetunge,stenslynge,dækvinge,tynge,badevinge,kattetunge,allonge,flange,lårtunge,brilleslange,coxorange,spuleslange,gasslange,bagtunge,troldeunge,æskulapslange,støvlunge,rørflange,tvinge,lydkonge,gårdlænge,kz-fange,vagtelkonge,siklinge,fortunge,midttunge	vænge,stænge
3	ejr	43	0.00035	17	26	sejr,lejr,træningslejr,koncentrationslejr,fangelejr,hjemmesejr,sommerlejr,arbejdslejr,teltlejr,udesejr,spejderlejr,pointsejr,pligtsejr,arbejdssejr,pyrrhussejr,etmålssejr,kz-lejr	vejr,regnvejr,uvejr,stormvejr,sommervejr,snevejr,vintervejr,tørvejr,tordenvejr,blæsevejr,gråvejr,frostvejr,solskinsvejr,forårsvejr,tøvejr,efterårsvejr,møgvejr,mundsvejr,haglvejr,bygevejr,aprilsvejr,magsvejr,opholdsvejr,ruskvejr,fygevejr,grødevejr
3	ane	96	0.00033	96	0	bane,hjemmebane,jernbane,udebane,midtbane,golfbane,fane,vane,letbane,chikane,fodboldbane,hane,svane,trane,vejbane,løbebane,kørebane,sædvane,gane,landingsbane,vandhane,glidebane,rutsjebane,skøjtebane,kane,tennisbane,karavane,boldbane,travbane,væddeløbsbane,skydebane,kostvane,sexchikane,undergrundsbane,spisevane,racerbane,madvane,privatbane,godsbane,vognbane,ridebane,startbane,galopbane,kortbane,svævebane,uvane,kamphane,busbane,forhindringsbane,togbane,langbane,grusbane,vejrhane,bowlingbane,inderbane,nærbane,kurtisane,brandhane,tunnelbane,højbane,tankebane,knopsvane,reberbane,snushane,unghane,knurhane,snaphane,sangsvane,slidbane,gokartbane,yderbane,midterbane,keglebane,gashane,brushane,røgfane,skateboardbane,tovbane,bjergbane,cindersbane,flane,forbryderbane,stophane,vildtbane,taphane,pibesvane,fasanhane,koldtvandshane,urhane,S-bane,sejrsfane,attenhullersbane,tjurhane,klemhane,nihullersbane,paravane	
3	aft	60	0.00033	51	9	kraft,arbejdskraft,hestekraft,drivkraft,saft,gennemslagskraft,citronsaft,atomkraft,sammenhængskraft,handlekraft,dømmekraft,vindkraft,købekraft,tyngdekraft,slagkraft,kernekraft,livskraft,håndkraft,vandkraft,modstandskraft,naturkraft,trækkraft,urkraft,kulkraft,sprængkraft,frugtsaft,taft,donkraft,centrifugalkraft,kødsaft,maskinkraft,hostesaft,bærekraft,druesaft,indbildningskraft,grokraft,solbærsaft,produktivkraft,hyldebærsaft,ribssaft,retskraft,virkekraft,hindbærsaft,lovkraft,råsaft,beviskraft,spændkraft,lærerkraft,dådskraft,a-kraft,bønskraft	skaft,kosteskaft,taft,økseskaft,snudeskaft,støvleskaft,knivskaft,strømpeskaft,spydskaft
3	ste	121	0.00033	116	5	kæreste,liste,tjeneste,efterretningstjeneste,gudstjeneste,venteliste,fortjeneste,kiste,hitliste,faste,rangliste,ekskæreste,buste,fyrste,næste,borgerliste,rolleliste,samfundstjeneste,kaste,børste,tandbørste,militærtjeneste,tipstjeneste,udenrigstjeneste,hoste,facitliste,bjørnetjeneste,lokalliste,vennetjeneste,sundhedstjeneste,prisliste,streamingtjeneste,tjekliste,ambulancetjeneste,ligkiste,litteraturliste,positivliste,skoletjeneste,dødsliste,indkøbsliste,mindegudstjeneste,partiliste,cyste,ordliste,vagttjeneste,skatkiste,bedriftssundhedstjeneste,kighoste,aftengudstjeneste,teletjeneste,huskeliste,playliste,konsulenttjeneste,iste,fildelingstjeneste,opvaskebørste,kurfyrste,dårekiste,mailingliste,dragkiste,rødliste,spaghettigudstjeneste,spilleliste,tabsliste,onlinetjeneste,bruttoliste,storfyrste,sortliste,stålbørste,toiletbørste,trækningsliste,negativliste,bedste,kantliste,inventarliste,pynteliste,skurebørste,hjernekiste,gentjeneste,neglebørste,skibskiste,strubehoste,slamkiste,tobakshoste,kramkiste,kurertjeneste,nødtjeneste,materialeliste,ekstrafortjeneste,eltandbørste,hellekiste,shortliste,klædebørste,civilliste,fejeliste,altertjeneste,weekendkæreste,præsensliste,varbørste,halvkaste,skråliste,friliste,skobørste,skyggeliste,tapetbørste,tegningsliste,krillehoste,dækliste,stødliste,vaterliste,dagtjeneste,dødeliste,stykliste,blankebørste,påsmørebørste,ekspektanceliste	fodfæste,rodfæste,fæste,bedste,landfæste
3	agt	94	0.00033	94	0	magt,jagt,vagt,dragt,stormagt,pagt,foragt,afmagt,ordensmagt,besættelsesmagt,supermagt,livvagt,statsmagt,lægevagt,nattevagt,dommervagt,sikkerhedsvagt,pragt,overmagt,fragt,skattejagt,klædedragt,døgnvagt,biljagt,fuldmagt,atommagt,kystvagt,heksejagt,klapjagt,andagt,ægtepagt,kongemagt,badedragt,kedeldragt,værnemagt,flyverdragt,træningsdragt,tragt,våddragt,folkedragt,spadseredragt,nationaldragt,aftenvagt,ringeagt,heldragt,dødsforagt,fjerdragt,morgenandagt,tilkaldevagt,luftfragt,stemmepragt,gårdvagt,almagt,buksedragt,fangedragt,joggingdragt,farvepragt,hubertusjagt,advokatvagt,svampejagt,selvforagt,brandvagt,sparkedragt,dagvagt,dykkerdragt,overlevelsesdragt,storvildtjagt,telefonvagt,brovagt,festdragt,æresvagt,bagvagt,generalfuldmagt,skildvagt,strandjagt,parforcejagt,strejkevagt,mandsdragt,hundevagt,frivagt,rekordjagt,ikkeangrebspagt,domsmagt,noksagt,forvagt,natdragt,kravledragt,hjemmedragt,velmagt,tvedragt,blankofuldmagt,pyrschjagt,signatarmagt,p-vagt	
3	ens	108	0.00033	103	5	konsekvens,tendens,eksistens,licens,ingrediens,intelligens,sekvens,konsistens,demens,frekvens,essens,turbulens,sameksistens,audiens,evidens,præcedens,residens,jens,resistens,abstinens,solvens,transparens,ambivalens,impotens,reminiscens,stringens,inkontinens,pestilens,sentens,sommerresidens,potens,medielicens,inkonsekvens,kondens,konvergens,magisterkonferens,insolvens,divergens,transcendens,dissens,reverens,interferens,rekonvalescens,proveniens,præsens,kvintessens,agens,inkonsistens,differens,filipens,ækvivalens,fluorescens,latens,kohærens,kongruens,indifferens,kontingens,konferens,korrespondens,senildemens,virulens,omnipotens,permanens,insufficiens,luminescens,inkongruens,karens,højfrekvens,multiresistens,indolens,valens,konveniens,clockfrekvens,koincidens,maskinrens,tangens,patiens,WC-rens,remanens,influens,inhærens,rens,koeksistens,impertinens,konsens,excellens,dependens,elokvens,fosforescens,ascendens,immanens,inkohærens,descendens,homo sapiens,subsistens,præeksistens,lavfrekvens,cotangens,tæpperens,bonsens,konfluens,bærefrekvens,sufficiens	nonsens,præcedens,præsens,reagens,delirium tremens
3	sme	400	0.00033	399	1	optimisme,turisme,terrorisme,racisme,kommunisme,organisme,kapitalisme,mekanisme,nazisme,realisme,socialisme,nationalisme,entusiasme,antisemitisme,liberalisme,kynisme,mikroorganisme,modernisme,fascisme,islamisme,konservatisme,professionalisme,humanisme,ekstremisme,fundamentalisme,idealisme,feminisme,populisme,autisme,orgasme,egoisme,pessimisme,buddhisme,fanatisme,marxisme,individualisme,nepotisme,minimalisme,alkoholisme,sarkasme,imperialisme,protektionisme,kulturradikalisme,materialisme,katolicisme,aktivisme,pluralisme,totalitarisme,surrealisme,patriotisme,lobbyisme,ateisme,multikulturalisme,markedsmekanisme,isme,pragmatisme,parlamentarisme,prisme,postmodernisme,bilisme,socialrealisme,zionisme,anakronisme,privatbilisme,kolonialisme,ekspressionisme,opportunisme,impressionisme,kannibalisme,naturalisme,stalinisme,funktionalisme,narcissisme,perfektionisme,dokumentarisme,hinduisme,analfabetisme,symbolisme,centralisme,protestantisme,sexisme,nationalsocialisme,relativisme,moralisme,radikalisme,klassicisme,forsvarsmekanisme,nihilisme,puritanisme,vandalisme,eksistentialisme,aforisme,eufemisme,rationalisme,eskapisme,cyklisme,dualisme,anarkisme,masseturisme,darwinisme,militarisme,magnetisme,sadisme,højreekstremisme,forbrugerisme,provinsialisme,kubisme,hooliganisme,amatørisme,chauvinisme,heroisme,nyliberalisme,positivisme,separatisme,universalisme,determinisme,pacifisme,pietisme,internationalisme,altruisme,grundtvigianisme,industrialisme,kommercialisme,masochisme,okkultisme,satanisme,føderalisme,hedonisme,mysticisme,nynazisme,elektromagnetisme,metabolisme,isolationisme,ekvilibrisme,kollektivisme,konstruktivisme,strukturalisme,højrepopulisme,formalisme,mandschauvinisme,fatalisme,spasme,amerikanisme,vitalisme,leninisme,kreationisme,kulturimperialisme,feudalisme,futurisme,nyklassicisme,sadomasochisme,historicisme,fetichisme,traditionalisme,naivisme,dadaisme,jihadisme,maoisme,monoteisme,ekshibitionisme,eksorcisme,holisme,skepticisme,spiritisme,revisionisme,statsterrorisme,voyeurisme,shamanisme,sufisme,bolsjevisme,absolutisme,intellektualisme,sekterisme,kommunitarisme,reduktionisme,hellenisme,konfucianisme,konformisme,absurdisme,højreradikalisme,salafisme,mongolisme,pladderhumanisme,fantasme,avantgardisme,manierisme,lukkemekanisme,eksotisme,dogmatisme,kulturturisme,anglicisme,stoicisme,sensualisme,victorianisme,vegetarisme,gnosticisme,zenbuddhisme,vulkanisme,nykonservatisme,utilitarisme,defaitisme,socialkonstruktivisme,økoturisme,calvinisme,behaviorisme,låsemekanisme,reformisme,regionalisme,nyrealisme,neologisme,paternalisme,dekonstruktivisme,farisæisme,primitivisme,fauvisme,romantisme,revanchisme,empirisme,demokratisme,senkapitalisme,højrenationalisme,socialliberalisme,kosmopolitisme,lutheranisme,elitisme,skandinavisme,nudisme,konkretisme,obskurantisme,irrationalisme,brutalisme,subjektivisme,utopisme,monisme,spiritualisme,panteisme,brosme,dilettantisme,etnocentrisme,despotisme,antropomorfisme,naturisme,eklekticisme,æsteticisme,purisme,antagonisme,monetarisme,platonisme,historisme,sikhisme,infantilisme,parkinsonisme,gaullisme,konsumerisme,evolutionisme,muhamedanisme,animisme,eurocentrisme,betonkommunisme,antimilitarisme,botulisme,synkretisme,lesbianisme,polyteisme,transvestisme,ekspansionisme,syndikalisme,venstreekstremisme,snobbisme,kolorisme,neutralisme,verisme,venstreradikalisme,nykolonialisme,negativisme,brandesianisme,germanisme,pleonasme,freudianisme,erotisme,shiisme,interventionisme,agnosticisme,messianisme,vegetarianisme,solipsisme,royalisme,veganisme,senmodernisme,korporatisme,reumatisme,bureaukratisme,sentimentalisme,tropisme,syllogisme,mormonisme,teisme,privatkapitalisme,nominalisme,akademisme,judaisme,nymarxisme,trotskisme,truisme,panarabisme,objektivisme,daoisme,urbanisme,gigantisme,shintoisme,baptisme,deisme,albinisme,atavisme,hegelianisme,antropocentrisme,varefetichisme,parallelisme,sofisme,dramadokumentarisme,papisme,pointillisme,georgisme,vanvidsbilisme,postkommunisme,sunnisme,bioterrorisme,monopolisme,privatisme,indeterminisme,decentralisme,korporativisme,alpinisme,lamaisme,nyfascisme,thomisme,machiavellisme,partikularisme,rigorisme,tachisme,klerikalisme,brahmanisme,bonapartisme,hermafroditisme,tsarisme,totemisme,nordisme,lamarckisme,epikuræisme,panafrikanisme,voluntarisme,arkaisme,vulgarisme,nomadisme,svecisme,polycentrisme,supranaturalisme,isomorfisme,psykologisme,perspektivisme,komparatisme,panamerikanisme,eudaimonisme,panslavisme,norvagisme,somnambulisme,kantianisme,latinisme,kabbalisme,konsonantisme,gallicisme,kretinisme,synkronisme,metodisme,unionisme,idiotisme,jesuitisme,seksualisme,barthianisme,paroksysme,kiasme,pangermanisme,danisme,orgiasme,unitarisme,cæsarisme,malthusianisme,kvietisme,presbyterianisme,hegemonisme,doktrinarisme,græcisme,panhellenisme,hypnotisme,flagellantisme,uniformisme,kulturisme,morfinisme,vokalisme	prisme
3	lub	25	0.00031	24	1	klub,boldklub,fodboldklub,natklub,håndboldklub,sejlklub,ungdomsklub,divisionsklub,roklub,fanklub,sportsklub,fritidsklub,bogklub,ældreklub,kaffeklub,kajakklub,filmklub,rockerklub,kortklub,spilleklub,karateklub,kennelklub,syklub,fællesklub	slub
3	ige	52	0.00031	39	13	pige,stige,prestige,intrige,barnepige,tjenestepige,stuepige,skolepige,rangstige,lige,kokkepige,bondepige,brudepige,lillepige,nissepige,syngepige,elverpige,trappestige,escortpige,glædespige,rebstige,hønsestige,gige,frelserpige,jakobsstige,nøddekrige,wienerstige,ungkarlepige,enepige,juhupige,stikirendpige,voltige,skydestige,folde ud-pige,gogopige,au pair-pige,otteårspige,musestige,lavskrige	rige,kongerige,dige,kejserrige,dødsrige,ørige,dyrerige,tusindårsrige,gudsrige,planterige,dronningerige,mineralrige,oldtidsrige
3	rat	91	0.00031	28	63	socialdemokrat,kammerat,demokrat,holdkammerat,pirat,klassekammerat,magistrat,bureaukrat,litterat,karat,skolekammerat,legekammerat,teknokrat,aristokrat,partikammerat,nitrat,sidekammerat,bonkammerat,autokrat,cellekammerat,kastrat,åndsaristokrat,grat,kaliumnitrat,plutokrat,flypirat,teokrat,calciumnitrat	apparat,referat,direktorat,sponsorat,præparat,høreapparat,emirat,professorat,krat,kasseapparat,kulhydrat,kvadrat,konglomerat,pastorat,produktionsapparat,nitrat,koncentrat,generaldirektorat,partiapparat,læderrat,tælleapparat,fotografiapparat,rektorat,protektorat,bevægeapparat,varmeapparat,triumvirat,sanseapparat,noteapparat,lektorat,defensorat,substrat,hormonpræparat,inspektorat,skrat,beslutningsreferat,kaldeapparat,gasapparat,ringeapparat,tjørnekrat,filmapparat,hydrat,kaliumnitrat,aktorat,spritapparat,priorat,ellekrat,induktionsapparat,seniorat,citrat,sulfapræparat,calciumnitrat,censorat,tastaturapparat,inserat,ildslukningsapparat,TV-apparat,stavmassageapparat,instruktorat,filtrat,agglomerat,sirat,klorat
3	ine	150	0.00031	147	3	mine,maskine,rutine,deadline,kantine,vaccine,kabine,hovedpine,line,filippine,marine,kusine,vaskemaskine,blondine,limousine,søgemaskine,flyvemaskine,lavine,skrivemaskine,opvaskemaskine,pengemaskine,boremaskine,pine,landmine,kaffemaskine,margarine,hotline,gravemaskine,aubergine,symaskine,livline,skyline,pipeline,turbine,kulmine,spillemaskine,landbrugsmaskine,kopimaskine,regnemaskine,brusekabine,dampmaskine,guideline,græsslåmaskine,kattepine,vridemaskine,georgine,guillotine,studine,mavepine,datamaskine,tandpine,punchline,køkkenmaskine,barbermaskine,gine,gelatine,skruemaskine,romaskine,røremaskine,fejemaskine,evighedsmaskine,piccoline,serpentine,vaseline,terrine,spændingshovedpine,konkubine,faskine,vitrine,kendermine,borderline,malkemaskine,slibemaskine,gasturbine,dræsine,plantemargarine,krinoline,høstmaskine,abonnine,flippermaskine,såmaskine,rugemaskine,slagboremaskine,grenadine,kødhakkemaskine,båndmaskine,trykkemaskine,sonatine,slåmaskine,sømine,helvedesmaskine,minarine,strikkemaskine,skæremaskine,kølemaskine,ørepine,poliovaccine,flagline,ravine,blandemaskine,grandkusine,antipersonelmine,fettuccine,vlieseline,undine,hæftemaskine,trykkabine,knusemaskine,brødmaskine,brillantine,fræsemaskine,gabardine,barkentine,hullemaskine,sættemaskine,rensemaskine,halvkusine,oregonpine,tappemaskine,rumkabine,terzine,brigantine,lodline,synkeline,håndline,tærskemaskine,stansemaskine,quiche lorraine,fangline,bænkboremaskine,mejemaskine,martyrmine,duvetine,clipsemaskine,hornmine,bobine,kavatine,grødeskæremaskine,flydeline,elektrisermaskine,grave-læsse-maskine,æltemaskine,tripelvaccine,pitchpine,skopudsemaskine,crepe de chine,hakkelsemaskine	vlieseline,gabardine,cuisine
3	ver	189	0.00030	168	21	arbejdsgiver,rådgiver,røver,indehaver,magthaver,socialrådgiver,sangskriver,iver,giver,lever,skriver,udøver,andelshaver,lovgiver,samlever,flyver,udgiver,sjover,server,revolver,bankrådgiver,trediver,bankrøver,nadver,oplever,bæver,långiver,velhaver,medindehaver,graver,sørøver,tyver,sportsudøver,traver,overlever,maldiver,driver,firkløver,gnaver,rettighedshaver,underskriver,trekløver,beskriver,brevskriver,anpartshaver,investeringsrådgiver,tilbudsgiver,retriever,rendegraver,liebhaver,guldgraver,kløver,væver,ellever,klummeskriver,landrover,angiver,receiver,spareiver,skrumpelever,panthaver,formgiver,kvaksalver,palaver,kontohaver,kalvelever,stiver,historieskriver,syver,pullover,naver,hjemmerøver,ordenshåndhæver,forlover,krønikeskriver,walkover,håndhæver,landevejsrøver,fartskriver,reformiver,gæstgiver,opgiver,kunderådgiver,kodriver,familierådgiver,parthaver,skæver,dagdriver,udebliver,rekordindehaver,svæveflyver,køkkenskriver,shaver,moldover,eneindehaver,tromlerevolver,syvsover,drageflyver,slaver,tolver,haderslever,klyver,brøndgraver,opkræver,staver,forstøver,genever,river,fedtlever,licenshaver,næsestyver,garver,kortindehaver,raver,bevillingshaver,stratenrøver,rødkløver,patenthaver,modelflyver,sorenskriver,over,djævleuddriver,slipover,tidrøver,ihændehaver,fordringshaver,gengiver,ordkløver,torskelever,lysgiver,støver,flipover,undergraver,livgiver,koncessionshaver,grøftegraver,sumpbæver,spilfordærver,kortgiver,vinkelskriver,ladyshaver,kassebedrøver,knever,møver,trosiver,labradorretriever,maskinskriver,bengnaver,ruteflyver,makeover,elver,udpantningshaver,hverver,ådselgraver,prioritetshaver,håndpanthaver,rodfordærver,golden retriever,alsikekløver,skattegraver,rethaver,kædegraver,voiceover,screensaver,tjenesteiver,mouseover,stenkløver,hårkløver	klaver,cover,pulver,vaskepulver,bagepulver,firkløver,trekløver,mælkepulver,kadaver,yver,naver,kakaopulver,hardcover,hammerklaver,skurepulver,kløpulver,blæver,grafitpulver,æggepulver,insektpulver,buddingpulver
3	rad	22	0.00030	22	0	grad,rygrad,breddegrad,sværhedsgrad,doktorgrad,kandidatgrad,minusgrad,mørbrad,varmegrad,mastergrad,plusgrad,detaljeringsgrad,kuldegrad,længdegrad,surhedsgrad,bænkerad,perlerad,farad,styrkegrad,benrad,mikrofarad,pikofarad	
3	rig	24	0.00030	16	8	krig,verdenskrig,borgerkrig,priskrig,atomkrig,borerig,religionskrig,nervekrig,guerillakrig,luftkrig,landkrig,stillingskrig,svenskekrig,brig,søkrig,tofrontskrig	skrig,ramaskrig,primalskrig,anskrig,nødskrig,himmerig,glædesskrig,jorderig
3	tte	136	0.00030	130	6	støtte,rotte,hytte,nytte,statsstøtte,skytte,latte,smitte,lette,skotte,trætte,blæksprutte,slette,hætte,statuette,bøtte,grotte,rødspætte,boligstøtte,snigskytte,måtte,operette,mælkebøtte,nakkestøtte,diskette,potte,kolbøtte,courgette,platte,etikette,fritte,snitte,brunette,nitte,emhætte,kassette,krybskytte,jydepotte,urtepotte,højslette,bueskytte,mediestøtte,skamstøtte,jætte,kutte,skarpskytte,sponsorstøtte,mitte,baguette,dørmåtte,spætte,lotte,culotte,putte,vinaigrette,tepotte,badehætte,samfundsstøtte,studiestøtte,plakette,lydpotte,skiskytte,gærdesmutte,natpotte,pipette,videokassette,kæmpeblæksprutte,rygstøtte,stenstøtte,hindbærsnitte,egennytte,skraldebøtte,georgette,saltstøtte,fyldebøtte,gnavpotte,flagspætte,kokotte,tehætte,suffragette,knaldhytte,munkekutte,grønspætte,kirkerotte,vandrotte,bogstøtte,kokette,pungrotte,musette,bademåtte,sivmåtte,sortspætte,bisamrotte,rillette,musemåtte,knaldhætte,vætte,karotte,gavotte,uegennytte,billedstøtte,ylette,novellette,rumlepotte,fænghætte,palmette,cuvette,hotelrotte,bæverrotte,grønsmutte,skarnbøtte,grænsenytte,chamotte,båndkassette,soubrette,kokosmåtte,garrotte,moskusrotte,eau de toilette,digesmutte,crepe georgette,caffe latte,jamborette,røghætte,reinette,vrøvlebøtte,faraorotte,tratte,burette,ritte	udbytte,bytte,krigsbytte,toilette,sidebytte,pianette
3	tiv	82	0.00030	21	61	aktiv,detektiv,privatdetektiv,superlativ,genitiv,imperativ,konjunktiv,akkusativ,nominativ,dativ,infinitiv,positiv,indikativ,ablativ,vokativ,komparativ,frikativ,optativ,narrativ,lokativ,gruppegenitiv	initiativ,alternativ,perspektiv,motiv,aktiv,direktiv,kollektiv,lokomotiv,negativ,stativ,regulativ,objektiv,adjektiv,kooperativ,damplokomotiv,korrektiv,ledemotiv,substantiv,fugleperspektiv,klatrestativ,landsplandirektiv,nodestativ,recitativ,gyngestativ,tørrestativ,additiv,akkreditiv,helikopterperspektiv,præservativ,diesellokomotiv,imperativ,frøperspektiv,centralperspektiv,prærogativ,diminutiv,demonstrativ,produktionskollektiv,positiv,præventiv,palliativ,teleobjektiv,portativ,zoomobjektiv,appellativ,verbalsubstantiv,relativ,intransitiv,kreditiv,kausativ,eruptiv,sedativ,prædikativ,sikkativ,participialadjektiv,transitiv,derivativ,interrogativ,vomitiv,situativ,fiksativ,laksativ
3	age	148	0.00029	147	1	anklage,klage,etage,kage,passage,bagage,reportage,garage,mage,emballage,drage,plantage,hage,stage,stueetage,massage,pandekage,lagkage,spionage,småkage,lækage,plage,collage,krage,sabotage,page,lage,lysestage,montage,ravage,kransekage,umage,flage,håndbagage,underetage,gage,karambolage,ekvipage,slitage,chokoladekage,hjertemassage,knage,klitplantage,personage,bandage,isflage,landeplage,moderkage,tagetage,æggekage,staffage,rævekage,plamage,apanage,industrispionage,courage,tonnage,kurtage,camouflage,blamage,sukkerlage,brunkage,fromage,overetage,honningkage,saltlage,sandkage,modhage,civilcourage,citronfromage,kontraspionage,fotomontage,bondage,eremitage,huskekage,fustage,corsage,menage,konditorkage,faunapassage,flødekage,islagkage,dobbelthage,iskage,bønnestage,karabinhage,ensilage,kiksekage,skærekage,smørkage,jødekage,tørkage,ægtemage,ostekage,napoleonskage,trikotage,drømmekage,klatkage,bådshage,madpandekage,marmorkage,bruttotonnage,søsterkage,jammerklage,othellolagkage,sojakage,arbitrage,gipsbandage,persiflage,kokage,flæskeæggekage,kartonnage,krydderkage,intimmassage,ålekrage,oliekage,foderkage,påklage,hirseflage,formkage,takkelage,othellokage,plumkage,fernissage,bikage,vinkelhage,fuselage,plumage,kolportage,astakage,bænkhage,sprydstage,chokokage,stjerthage,rubinsteinkage,trehage,platmenage,brækage,veklage,klemhage,spærhage,klassens time-kage,ellekrage,new age,dekolletage,håkonskage,affutage	image
3	dat	27	0.00029	23	4	soldat,kandidat,præsidentkandidat,spidskandidat,folketingskandidat,modkandidat,jægersoldat,lejesoldat,marinesoldat,partisoldat,tinsoldat,forstkandidat,kommandosoldat,selvmordskandidat,landsoldat,frontsoldat,dumpekandidat,turnuskandidat,lærerkandidat,barnesoldat,tofagskandidat,frelsersoldat,etfagskandidat	mandat,kredsmandat,tillægsmandat,konkordat
3	ryk	59	0.00029	2	57	paryk,allongeparyk	udtryk,indtryk,tryk,blodtryk,skattetryk,fingeraftryk,aftryk,håndtryk,højtryk,ansigtsudtryk,modtryk,helhedsindtryk,eftertryk,sanseindtryk,lavtryk,dæktryk,genoptryk,lufttryk,fagudtryk,overtryk,smagsindtryk,undertryk,optryk,slangudtryk,vandtryk,silketryk,særtryk,kraftudtryk,bogtryk,stoftryk,guldtryk,kobbertryk,olietryk,stentryk,linoleumstryk,fejltryk,akseltryk,påtryk,blåtryk,småtryk,dybtryk,gastryk,skillingstryk,fortryk,forhåndsindtryk,offsettryk,lystryk,flerfarvetryk,hovedtryk,bloktryk,blindtryk,voksaftryk,rentryk,bitryk,fladtryk,svagtryk,betryk
3	rav	27	0.00029	17	10	grav,massegrav,grusgrav,skyttegrav,voldgrav,orkestergrav,banegrav,lergrav,krigergrav,vandgrav,springgrav,rævegrav,tørvegrav,urnegrav,smøregrav,grævlingegrav,arkitrav	krav,trav,lovkrav,mindstekrav,modkrav,kvalifikationskrav,efterkrav,påkrav,luntetrav,pensumkrav
3	akt	44	0.00029	41	3	kontakt,kontrakt,takt,optakt,lejekontrakt,nærkontakt,øjenkontakt,stikkontakt,autodidakt,sagsakt,stigningstakt,skakt,retsakt,ekstrakt,hævnakt,leasingkontrakt,kropskontakt,mineskakt,spillerkontrakt,ungdomskontrakt,elevatorskakt,slutakt,lyskontakt,utakt,affaldsskakt,viljesakt,købekontrakt,kønsakt,mellemakt,parringsakt,lærekontrakt,vejkontakt,katarakt,nedstyrtningsskakt,skaberakt,nedfaldsskakt,firefjerdedelstakt,grubeskakt,hyldningsakt,trefjerdedelstakt,seksottendedelstakt	abstrakt,ekstrakt,artefakt
3	sik	52	0.00029	52	0	musik,fysik,rockmusik,folkemusik,popmusik,jazzmusik,kammermusik,dansemusik,populærmusik,verdensmusik,livemusik,metafysik,underlægningsmusik,barokmusik,kormusik,baggrundsmusik,soulmusik,hornmusik,rapmusik,spillemandsmusik,atomfysik,kvantefysik,klassik,astrofysik,fremtidsmusik,instrumentalmusik,geofysik,technomusik,fusionsmusik,pigtrådsmusik,kernefysik,beatmusik,vokalmusik,biofysik,reggaemusik,tolvtonemusik,borgermusik,stemningsmusik,diskomusik,elektronmusik,salonmusik,ledsagemusik,taffelmusik,programmusik,faststoffysik,højenergifysik,brugsmusik,bigbandmusik,helsefysik,psykofysik,kattemusik,klesmermusik	
3	rne	65	0.00028	59	6	stjerne,hjerne,kerne,kaserne,superstjerne,verdensstjerne,filmstjerne,rockstjerne,stemmeurne,bykerne,urne,lanterne,ledestjerne,pinjekerne,valgurne,barnestjerne,sangstjerne,cisterne,søstjerne,terne,orne,atomkerne,arne,solsikkekerne,cellekerne,nøddekerne,nocturne,kærne,davidsstjerne,michelinstjerne,morgenstjerne,jødestjerne,kæmpestjerne,lucerne,klæbehjerne,norne,lillehjerne,sauterne,borne,dobbeltstjerne,guldstjerne,aftenstjerne,storhjerne,fiksstjerne,vindruekerne,betlehemsstjerne,koturne,bakkestjerne,kaverne,fladstjerne,skovstjerne,gardekaserne,frøstjerne,dagpragtstjerne,chili con carne,blåstjerne,toplanterne,pragtstjerne,varietéstjerne	hjørne,gadehjørne,verdenshjørne,snakkehjørne,vindhjørne,chili con carne
3	ram	60	0.00028	3	57	pram,dram,skydepram	program,gram,kilogram,kram,isenkram,diagram,telegram,underholdningsprogram,principprogram,anagram,milligram,monogram,koncertprogram,piktogram,hologram,handlingsprogram,wolfram,quizprogram,antivirusprogram,regionalprogram,elektrokardiogram,søjlediagram,nanogram,pentagram,epigram,skåneprogram,fonogram,kryptogram,seismogram,videogram,parallelogram,cirkeldiagram,aerogram,kardiogram,ideogram,elektroencefalogram,blokdiagram,histogram,stenogram,spektrogram,CAD-program,encefalogram,trepunktsprogram,buckram,hektogram,stereogram,centigram,decigram,dekagram,open source-program,rutediagram,cad-program,heksagram,femtogram,organigram,indlæseprogram,floragram
3	ert	55	0.00028	55	0	koncert,ekspert,kuffert,knallert,dessert,kuvert,kikkert,brandert,dukkert,bommert,sællert,skonnert,skævert,rudekuvert,pibekoncert,ellert,kleppert,frækkert,promenadekoncert,mukkert,pullert,camembert,stjernekikkert,slambert,sievert,daggert,slubbert,vipstjert,evert,rullekuffert,javert,snert,sjofert,drivert,kæfert,drønnert,huggert,prismekikkert,førstedagskuvert,rødstjert,hævert,piskesnert,hivert,fjert,dryppert,kabinekuffert,boblekuvert,kurvekuffert,kroppert,bramsejlsskonnert,hukkert,tykkert,pjækkert,stjert,dørkikkert	
3	æge	32	0.00027	32	0	læge,overlæge,tandlæge,speciallæge,dyrlæge,embedslæge,reservelæge,vagtlæge,cheflæge,øjenlæge,børnelæge,livlæge,ørelæge,skolelæge,kræftlæge,stadslæge,væge,tæge,stabslæge,huslæge,naturlæge,distriktslæge,kredslæge,skoletandlæge,stadsdyrlæge,natlæge,generallæge,retslæge,barfodslæge,kræge,underlæge,øre-næse-hals-læge	
3	kud	35	0.00027	0	35		overskud,underskud,tilskud,skud,startskud,indskud,bloktilskud,forskud,påskud,kosttilskud,stjerneskud,løntilskud,langskud,pletskud,børnetilskud,fejlskud,vildskud,udskud,vådeskud,topskud,grundskud,muldvarpeskud,hopskud,rodskud,bambusskud,hekseskud,strejfskud,skræmmeskud,kalktilskud,æbleskud,skumpelskud,nådeskud,flugtskud,hjerteskud,sammenskud
3	gen	40	0.00027	19	21	morgen,hensyntagen,stillingtagen,helgen,afstandtagen,figen,røntgen,borgen,skytshelgen,margen,ørefigen,pinsemorgen,fejlmargen,spørgejørgen,søjlehelgen,højremargen,indtrængen,venstremargen,afskedtagen	lagen,østrogen,oxygen,hydrogen,allergen,nitrogen,antigen,kollagen,halogen,hallucinogen,glykogen,gestagen,springlagen,badelagen,skarlagen,stiklagen,mutagen,underlagen,karcinogen,overlagen,stræklagen
3	ælp	25	0.00027	25	0	hjælp,kontanthjælp,nødhjælp,hjemmehjælp,førstehjælp,dødshjælp,bistandshjælp,lægehjælp,starthjælp,selvhjælp,krisehjælp,lektiehjælp,mødrehjælp,retshjælp,hushjælp,socialhjælp,medhjælp,fattighjælp,nabohjælp,våbenhjælp,fødselshjælp,studentermedhjælp,autohjælp,akuthjælp,tørkehjælp	
3	tel	58	0.00027	37	21	titel,undertitel,kittel,bagatel,apostel,bugspytkirtel,mørtel,pastel,kjortel,bogtitel,kirtel,vagtel,epistel,skjoldbruskkirtel,sundhedsapostel,spartel,lymfekirtel,fistel,blærehalskirtel,vindbøjtel,spatel,spytkirtel,tarantel,svedkirtel,talgkirtel,betel,kønskirtel,drittel,skyttel,tårekirtel,pudsemørtel,immortel,klummetitel,fedtkirtel,kautel,pustel,kolumnetitel	hotel,kapitel,kartel,stel,badehotel,luksushotel,luftkastel,kastel,klientel,motel,understel,brillestel,hostel,spisestel,ordenskapitel,domkapitel,testel,flotel,epitel,insekthotel,kautel
3	are	66	0.00027	62	4	vare,fare,fødevare,råvare,software,skare,livsfare,drikkevare,madvare,hare,mare,mærkevare,dagligvare,mangelvare,hardware,fanfare,hærskare,handelsvare,kopivare,smittefare,metervare,hvidevare,mellemvare,brandfare,tobaksvare,slagvare,færdigvare,vårhare,snare,kolonialvare,tilhængerskare,grovvare,ferskvare,røgvare,lagervare,timeshare,strikvare,tilhørerskare,tekstilvare,konsumvare,sekundavare,trævare,malervare,snehare,dybfrostvare,shareware,lervare,galanterivare,stabelvare,freeware,kokleare,engleskare,billigvare,konditorvare,medicinalvare,korpusvare,godtkøbsvare,kurare,transitvare,serievare,klædevare,materialvare	software,hardware,shareware,freeware
3	hef	34	0.00026	34	0	chef,topchef,kontorchef,koncernchef,departementschef,kommunikationschef,souschef,salgschef,teaterchef,køkkenchef,forsvarschef,udviklingschef,turistchef,personalechef,stabschef,programchef,produktchef,butikschef,socialchef,statschef,kompagnichef,maskinchef,brandchef,hofchef,kabinetschef,laboratoriechef,logistikchef,lagerchef,protokolchef,receptionschef,seniorchef,værnschef,eskadrechef,juniorchef	
3	eng	54	0.00025	54	0	dreng,seng,streng,dobbeltseng,tøsedreng,skoledreng,sygeseng,gadedreng,navlestreng,strandeng,gulddreng,køjeseng,moppedreng,himmelseng,ægteseng,trækkerdreng,spejderdreng,ginseng,bondedreng,bydreng,flaskedreng,vandseng,bolddreng,messedreng,drømmeseng,barneseng,skibsdreng,solseng,tremmeseng,klokkestreng,hyrdedreng,feltseng,stikirenddreng,kordreng,læredreng,dæksdreng,poppedreng,flodseng,harpestreng,vogterdreng,skomagerdreng,etageseng,buestreng,kaneseng,sotteseng,halvandenmandsseng,udtræksseng,syvårsdreng,seksårsdreng,prokrustesseng,nasi goreng,g-streng,stolpeseng,fireårsdreng	
3	lge	36	0.00025	34	2	følge,bølge,rækkefølge,selvfølge,alge,flodbølge,hedebølge,chokbølge,arvefølge,galge,radiobølge,lydbølge,trykbølge,mikrobølge,senfølge,tronfølge,blågrønalge,rangfølge,varmebølge,bærebølge,grønalge,kuldebølge,hækbølge,kiselalge,kortbølge,tidsfølge,rødalge,mellembølge,brunalge,langbølge,trinfølge,kransnålalge,trangfølge,blåalge	følge,ligfølge
3	lev	20	0.00025	20	0	elev,skoleelev,gymnasieelev,bankelev,skuespillerelev,kokkeelev,mønsterelev,sygeplejeelev,slev,kostelev,konstabelelev,butikselev,frisørelev,HHX-elev,EGU-elev,HF-elev,HG-elev,EFG-elev,HH-elev,HTX-elev	
3	reb	42	0.00024	2	40	greb,møggreb	angreb,begreb,indgreb,overgreb,terrorangreb,greb,indbegreb,modangreb,jerngreb,kontraangreb,frontalangreb,faldereb,vejgreb,kunstgreb,æresbegreb,fejlgreb,nøglebegreb,grundbegreb,gudsbegreb,ladegreb,kvælergreb,dørgreb,håndgreb,højreb,dobbeltgreb,stormangreb,overbegreb,tværreb,misgreb,skinangreb,slynggreb,flankeangreb,pistolgreb,mellemreb,hyssingreb,underbegreb,slænggreb,undergreb,tankangreb,føregreb
3	lje	45	0.00024	45	0	vilje,detalje,pulje,medalje,guldmedalje,patrulje,portefølje,modvilje,velvilje,sølvmedalje,bronzemedalje,uvilje,vanilje,talje,fortjenstmedalje,balje,batalje,lilje,dødspatrulje,offervilje,emalje,påskelilje,skolepatrulje,fightervilje,uropatrulje,forhandlingsvilje,slædepatrulje,pinselilje,hvepsetalje,tapperhedsmedalje,genpulje,kanalje,vrangvilje,daglilje,murerbalje,egenvilje,semulje,dorotealilje,travalje,trolje,gøgelilje,pragtlilje,sværdlilje,belladonnalilje,giftlilje	
3	ost	91	0.00024	89	2	post,frokost,kost,julefrokost,frost,aktiepost,ministerpost,tillidspost,præsidentpost,most,hverdagskost,kompost,gedeost,chefpost,ripost,nattefrost,forpost,rygeost,gældspost,permafrost,fetaost,udkigspost,parmesanost,flødeost,flaskepost,påskefrokost,vagtpost,uriaspost,smalkost,blåskimmelost,helsekost,udpost,dybfrost,pakkepost,råkost,hytteost,skånekost,rimfrost,husmandskost,fejekost,retrætepost,skæreost,friskost,lyttepost,kommandopost,vandpost,schweizerost,arbejdsfrokost,smøreost,gammelost,luftpost,skimmelost,myseost,smelteost,støvekost,tørkost,barfrost,hvidskimmelost,æblemost,fuldkost,katost,fattigmandskost,rørpost,hvidtekost,kurerpost,rødkitost,kalkkost,mandefrokost,fåremælksost,roquefortost,kommenost,blokpost,salatost,jobspost,goudaost,skørost,sultekost,grønskimmelost,B-post,tjærekost,riveost,A-post,sydost,blomsterkost,e-post,stiltonost,ejdammerost,elementarkost,nordost	host,boost
3	omi	29	0.00024	28	1	økonomi,privatøkonomi,markedsøkonomi,samfundsøkonomi,gastronomi,anatomi,autonomi,astronomi,planøkonomi,nationaløkonomi,oplevelsesøkonomi,driftsøkonomi,deleøkonomi,ergonomi,vidensøkonomi,sodomi,blandingsøkonomi,dikotomi,undergrundsøkonomi,taksonomi,naturalieøkonomi,antinomi,kolostomi,agronomi,trakeotomi,vasektomi,heteronomi,klitoridektomi	fysiognomi
3	bud	35	0.00024	0	35		tilbud,forbud,udbud,afbud,påbud,postbud,købstilbud,rygeforbud,dagtilbud,opbud,navneforbud,jobtilbud,fogedforbud,avisbud,indrejseforbud,slagtilbud,gæstebud,totalforbud,overbud,cykelbud,sendebud,ombud,landpostbud,overpostbud,bybud,startforbud,stopforbud,køtilbud,taleforbud,underbud,ilbud,telegrafbud,spilleforbud,rigsombud,skrabud
3	æde	58	0.00024	25	33	glæde,kæde,livsglæde,arbejdsglæde,fødekæde,væde,butikskæde,halskæde,slæde,bjergkæde,bagkæde,køreglæde,lyskæde,hundeslæde,perlekæde,selvglæde,snekæde,kvæde,telefonkæde,bobslæde,hundeæde,skaberglæde,sikkerhedskæde,smittekæde,samleglæde	tørklæde,hovedsæde,bagsæde,sæde,stræde,klæde,håndklæde,højsæde,forsæde,førersæde,halstørklæde,forklæde,lommetørklæde,foretræde,splitbagsæde,herresæde,kvæde,silketørklæde,lændeklæde,dommersæde,katapultsæde,barnesæde,partisantørklæde,hundeæde,nattesæde,klapsæde,papirlommetørklæde,frottéhåndklæde,hovedklæde,pyntelommetørklæde,twinsæde,sammentræde,kittelforklæde
3	nst	41	0.00023	40	1	kunst,gevinst,billedkunst,samtidskunst,gunst,sidegevinst,filmkunst,malerkunst,kursgevinst,scenekunst,brugskunst,vandkunst,kogekunst,dunst,ugunst,fortællekunst,popkunst,skuespilkunst,tryllekunst,bygningskunst,konceptkunst,lægekunst,brunst,skrivekunst,balancekunst,digtekunst,bogtrykkerkunst,performancekunst,tegnekunst,billedhuggerkunst,tonekunst,fiduskunst,konjunkturgevinst,sortekunst,vævekunst,fægtekunst,multikunst,kortkunst,trommesalskunst,sortkunst	gespenst
3	rud	45	0.00023	4	41	brud,barnebrud,luciabrud,sølvbrud	brud,indbrud,gennembrud,sammenbrud,udbrud,opbrud,løftebrud,skybrud,nybrud,vulkanudbrud,frembrud,lovbrud,nedbrud,kraniebrud,skibbrud,tøbrud,hovedbrud,knoglebrud,vredesudbrud,tillidsbrud,benbrud,nervesammenbrud,stenbrud,grundlovsbrud,kontraktbrud,kalkbrud,skrud,monopolbrud,regelbrud,stilbrud,raseriudbrud,soloudbrud,traktatbrud,bækkenbrud,digebrud,afbrud,retsbrud,granitbrud,vårbrud,anbrud,tandbrud
3	eau	28	0.00023	3	25	cadeau,rouleau,frikandeau	niveau,nyhedsbureau,bureau,rejsebureau,reklamebureau,prisniveau,turistbureau,aktivitetsniveau,vikarbureau,tableau,topniveau,plateau,bundniveau,politbureau,kursniveau,pressebureau,bookingbureau,mellemniveau,højniveau,oplysningsbureau,escortbureau,chateau,brugerniveau,trusselniveau,chevreau
3	syn	43	0.00023	0	43		hensyn,fjernsyn,tilsyn,udsyn,gensyn,eftersyn,menneskesyn,opsyn,forsyn,livssyn,selvsyn,særsyn,serviceeftersyn,klarsyn,sortsyn,snæversyn,kvindesyn,øjesyn,gennemsyn,bilsyn,ligsyn,helhedssyn,grundsyn,åsyn,drømmesyn,fremsyn,tunnelsyn,kasseeftersyn,nysyn,hegnssyn,skarpsyn,overopsyn,lyssyn,påsyn,brandsyn,vidsyn,indsyn,sprogsyn,tvesyn,gammelmandssyn,svagsyn,pietetshensyn,storsyn
3	nke	59	0.00022	59	0	tanke,mistanke,bunke,enke,eftertanke,omtanke,anke,banke,skranke,rynke,skinke,planke,lænke,klinke,bagtanke,flanke,fodlænke,sminke,vidneskranke,tvangstanke,redningsplanke,kongstanke,finke,manke,ranke,lunke,parmaskinke,strøtanke,kompostbunke,sænke,sinke,junke,rænke,vinranke,smilerynke,bogfinke,tågebanke,bynke,funke,klunke,bayonneskinke,spegeskinke,østersbanke,madsminke,muslingebanke,kvækerfinke,fiskebanke,pusselanke,landskinke,gråbynke,græsenke,guldranke,druemunke,blåmunke,humleranke,væverfinke,check-in-skranke,skybanke,flyvetanke	
3	ret	127	0.00022	121	6	landsret,højesteret,byret,cigaret,hovedret,forret,stemmeret,ejendomsret,ophavsret,skifteret,folkeret,vetoret,livret,fogedret,eneret,taburet,landsskatteret,menneskeret,valgret,indfødsret,strafferet,forvaltningsret,uret,kabaret,karet,fortrydelsesret,minaret,færdigret,råderet,møderet,rigsret,fiskeret,voldgiftsret,fortrinsret,forkøbsret,dagpengeret,beret,gryderet,klageret,brugsret,skoleret,skatteret,kødret,arveret,baret,selvbestemmelsesret,pastaret,nationalret,egnsret,tegningsret,kriminalret,førsteret,selskabsret,forfatningsret,returret,klaret,førerret,deputeret,fortegningsret,håneret,statsret,delegeret,familieret,krigsret,civilret,kommitteret,forhandlingsret,asylret,socialret,førstefødselsret,taleret,ligeret,samkvemsret,standret,borgerret,nødret,byggeret,underret,madret,fleuret,samværsret,formueret,køberet,immaterialret,romerret,søret,procesret,efterret,forkørselsret,jagtret,bytteret,hofret,dispositionsret,havret,herreret,sædvaneret,filtercigaret,patentret,privatret,obligationsret,skueret,statsborgerret,købsret,allemandsret,trækningsret,højhedsret,lampret,påtaleret,panteret,tingsret,strandret,tilbageholdsret,a la carte-ret,e-cigaret,chefdelegeret,territorialret,personret,tallerkenret,kosherret,næringsret,eksterritorialret	dekret,lazaret,sekret,arboret,feltlazaret,konkret
3	sag	33	0.00022	33	0	årsag,retssag,mærkesag,straffesag,grønsag,enkeltsag,dødsårsag,hovedsag,drabssag,tryksag,injuriesag,hjertesag,smagssag,kriminalsag,kvindesag,privatsag,oldsag,hastesag,tabersag,formssag,æressag,trossag,arvesag,ekspeditionssag,tillidssag,skønssag,vanesag,modesag,livssag,nådessag,tys-tys-sag,viljessag,domssag	
3	ard	35	0.00022	21	14	milliard,standard,levestandard,boulevard,forward,leopard,bodyguard,yard,hasard,bastard,steward,gepard,centerforward,lombard,langobard,poulard,billiard,trilliard,hellebard,mansard,togsteward	keyboard,billard,hasard,wildcard,skateboard,snowboard,billboard,keglebillard,smartboard,storyboard,whiteboard,clipboard,wakeboard,paddleboard
3	sor	27	0.00021	27	0	professor,revisor,sponsor,censor,statsrevisor,sensor,processor,kompressor,rigsrevisor,foodprocessor,politiassessor,supervisor,retsassessor,aggressor,regnsensor,mikroprocessor,assessor,togrevisor,parkeringssensor,bevægelsessensor,provisor,cursor,defensor,divisor,lyssensor,successor,kondensor	
3	log	119	0.00021	116	3	dialog,psykolog,katalog,arkæolog,biolog,sociolog,teolog,blog,antropolog,monolog,meteorolog,geolog,nekrolog,prolog,politolog,sexolog,økolog,ideolog,ornitolog,astrolog,zoolog,skolepsykolog,gynækolog,neurolog,kriminolog,kultursociolog,bagkatalog,etnolog,datalog,børnepsykolog,filolog,kosmetolog,epilog,chefideolog,palæontolog,havbiolog,krisepsykolog,mikrobiolog,patolog,klimatolog,radiolog,religionssociolog,marinbiolog,neuropsykolog,fysiolog,egyptolog,grafolog,glaciolog,bromatolog,teknolog,socialantropolog,sinolog,immunolog,toksikolog,virolog,dermatolog,vildtbiolog,entomolog,fænomenolog,udviklingspsykolog,kinesiolog,seismolog,reumatolog,bakteriolog,kardiolog,runolog,dybdepsykolog,gemmolog,bioteknolog,ernæringsfysiolog,neurofysiolog,genealog,allergolog,kremlolog,humanbiolog,gestaltpsykolog,mineralog,lektionskatalog,ufolog,nanoteknolog,mytolog,videoblog,indolog,otolog,odontolog,frenolog,laryngolog,futurolog,etolog,onkolog,metrolog,vlog,farmakolog,hippolog,herpetolog,sprogteknolog,terminolog,eskimolog,epidemiolog,numerolog,anæstesiolog,sprogpsykolog,histolog,assyriolog,oftalmolog,gerontolog,oceanolog,limnolog,serolog,vulkanolog,dendrolog,venerolog,geobiolog,urolog,dialektolog,gruppepsykolog	katalog,bagkatalog,lektionskatalog
3	ats	22	0.00021	21	1	indsats,sats,arbejdsindsats,disputats,rentesats,doktordisputats,procentsats,fundats,toldsats,opsats,ansats,afsats,tændsats,trappeafsats,lønsats,klippeafsats,visitats,fotosats,kraftindsats,forsats,kollats	sats
3	nse	43	0.00021	43	0	grænse,linse,landegrænse,aldersgrænse,pinse,spærregrænse,skanse,fattigdomsgrænse,kommunegrænse,chimpanse,smertegrænse,fartgrænse,hastighedsgrænse,bagatelgrænse,bygrænse,kontaktlinse,bundgrænse,lanse,promillegrænse,støjgrænse,suspense,overgrænse,telelinse,sultegrænse,kvalmegrænse,trægrænse,sproggrænse,snegrænse,fiskerigrænse,undergrænse,søgrænse,toldgrænse,trense,skovgrænse,pønitense,landgrænse,spredelinse,samlelinse,frynse,stanse,takstgrænse,commonsense,tremilegrænse	
3	råd	56	0.00021	27	29	tråd,gråd,pigtråd,ledetråd,ståltråd,rigsråd,ambassaderåd,etatsråd,sytråd,presseråd,tandtråd,metaltråd,handelsråd,udenrigsråd,glødetråd,gehejmeråd,konferensråd,krampegråd,rynketråd,ritråd,legationsråd,kinesertråd,undertråd,overtråd,ariadnetråd,føletråd,valsetråd	byråd,tråd,menighedsråd,samråd,ministerråd,regionsråd,tilsynsråd,ordforråd,studenterråd,forskningsråd,landsråd,skatteråd,elevråd,sogneråd,uråd,statsråd,husråd,forråd,konfliktråd,rigsråd,skoleråd,forældreråd,fagråd,husgeråd,lærerråd,skyldråd,krigsråd,ældsteråd,ligestillingsråd
3	løb	69	0.00021	0	69		beløb,forløb,cykelløb,vandløb,kredsløb,kapløb,tilløb,udløb,opløb,etapeløb,parløb,omløb,afløb,skiløb,maratonløb,stormløb,sagsforløb,forhandlingsforløb,orienteringsløb,karriereforløb,grundbeløb,styrtløb,væddeløb,engangsbeløb,racerløb,handlingsforløb,våbenkapløb,landevejsløb,seksdagesløb,gennemløb,friløb,travløb,havneløb,anløb,kunstskøjteløb,sololøb,hækkeløb,blodomløb,stafetløb,skøjteløb,overløb,medløb,hurtigløb,tidsforløb,indløb,restbeløb,geværløb,galopløb,natløb,tilbageløb,terrænløb,sprinterløb,ultraløb,nedløb,snigløb,fremløb,kondiløb,sejlløb,sækkevæddeløb,sækkeløb,totalbeløb,sammenløb,ligeløb,bøsseløb,figurløb,a conto-beløb,spidsrodsløb,hurdleløb,greyhoundløb
3	let	91	0.00021	71	20	billet,plet,ballet,atlet,flybillet,tablet,palet,cabriolet,returbillet,filet,stilet,enkeltbillet,kotelet,fribillet,skamplet,pamflet,omelet,tartelet,fiskefilet,skønhedsplet,triatlet,paillet,skattebillet,amulet,starlet,solplet,pladsbillet,bullet,dublet,endagsbillet,støvlet,polet,laksefilet,complet,brystfilet,rustplet,fedtplet,voksenbillet,jazzballet,brusetablet,entrébillet,epaulet,sugetablet,fugtplet,stråleplet,tillægsbillet,morgencomplet,pellet,dobbeltbillet,timebillet,applet,kyllingebrystfilet,multivitamintablet,flageolet,tyndstegsfilet,tykstegsfilet,snydetablet,andebrystfilet,kavalet,duatlet,barnebillet,andenklassesbillet,roulet,soklet,biatlet,kuplet,outlet,cassoulet,blindtablet,lommelet,paraatlet	toilet,plet,skelet,herretoilet,dametoilet,flet,gæstetoilet,complet,kurveflet,sølvplet,morgencomplet,multtoilet,rørflet,shibbolet,outlet,pileflet,elektroplet,juleflet,korselet,vandsparetoilet
3	ægt	67	0.00021	67	0	vægt,indtægt,voldtægt,slægt,knægt,overvægt,vedtægt,varetægt,tyveknægt,hovedvægt,modvægt,ligevægt,selvtægt,renteindtægt,egenvægt,totalvægt,sværvægt,weltervægt,dødvægt,undervægt,massevoldtægt,letvægt,mellemvægt,badevægt,gruppevoldtægt,fødselsvægt,politivedtægt,håndvægt,letsværvægt,merindtægt,bantamvægt,letweltervægt,uligevægt,guldvægt,biindtægt,efterslægt,fjervægt,aftægt,bruttoindtægt,letmellemvægt,fluevægt,cruiservægt,landsknægt,supersværvægt,byplanvedtægt,køkkenvægt,kontravægt,skarnsknægt,slagtevægt,hyldeknægt,sindsligevægt,brevvægt,letfluevægt,brovægt,fjedervægt,bismervægt,rumvægt,skålvægt,sjægt,støvleknægt,bruttovægt,skydelodsvægt,stangvægt,flydevægt,tevandsknægt,decimalvægt,sundhedsvedtægt	
3	jer	46	0.00021	46	0	ejer,boligejer,lejer,medejer,husejer,fjer,udlejer,gårdejer,godsejer,bilejer,dagplejer,bajer,lodsejer,grundejer,gletsjer,plejer,ketsjer,galleriejer,skorstensfejer,tandplejer,bådejer,kioskejer,daglejer,vejer,drejer,gadefejer,sygeplejer,tennisketsjer,strudsefjer,selvejer,mejer,plebejer,kvajebajer,halefjer,lurendrejer,svingfjer,fodplejer,svajer,høkerbajer,fremlejer,vingefjer,gemsefjer,styrefjer,dækfjer,ridsefjer,flyttebajer	
3	lad	57	0.00020	10	47	aflad,gedeblad,bukkeblad,tornblad,søblad,hornblad,pilblad,skeblad,firblad,sylblad	blad,dagblad,ugeblad,fagblad,laurbærblad,dameblad,barberblad,kronblad,figenblad,sladderblad,kirkeblad,skulderblad,flyveblad,generalieblad,titelblad,palmeblad,rosenblad,skoleblad,distriktsblad,faneblad,teblad,bøgeblad,knivblad,fejeblad,løsblad,bægerblad,dækblad,kimblad,kløverblad,savblad,hjerteblad,dæksblad,støvblad,vognlad,romanblad,bovblad,spydblad,smudsblad,tippelad,omblad,skovlblad,økseblad,rørblad,skilleblad,skeblad,vippelad,skrueblad
3	fon	34	0.00020	33	1	telefon,mobiltelefon,mikrofon,saxofon,megafon,hovedtelefon,høretelefon,tyfon,grammofon,diktafon,chiffon,dørtelefon,vibrafon,tenorsaxofon,biltelefon,xylofon,mønttelefon,kolofon,altsaxofon,nødtelefon,sopransaxofon,øretelefon,trykknaptelefon,hydrofon,sifon,barytonsaxofon,korttelefon,sousafon,porttelefon,hustelefon,videofon,homofon,metallofon	chiffon
3	ati	26	0.00020	10	16	sympati,empati,apati,antipati,psykopati,homøopati,telepati,biopati,sociopati,osteopati	demokrati,socialdemokrati,bureaukrati,diplomati,nærdemokrati,aristokrati,autokrati,teokrati,teknokrati,meritokrati,millimeterdemokrati,folkedemokrati,penduldiplomati,plutokrati,åndsaristokrati,virksomhedsdemokrati
3	ind	116	0.00020	49	67	vind,pind,kind,medvind,modvind,lind,hind,vestenvind,styrepind,sidevind,strikkepind,hvirvelvind,slikkepind,pegepind,ispind,spisepind,rorpind,limpind,grind,drillepind,vatpind,østenvind,solvind,kastevind,nordenvind,pålandsvind,fralandsvind,stormvind,pølsepind,rundpind,passatvind,opvind,trækvind,søndenvind,nordvestenvind,sydvestenvind,nærigpind,kløpind,nordøstenvind,kræsenpind,frossenpind,avind,sydøstenvind,vissenpind,gniepind,bærepind,ferskenkind,dåhind,vrangpind	sind,bind,tusind,skind,frisind,årtusind,gevind,ringbind,iltsvind,spind,opspind,rykind,storsind,samfundssind,svind,tankespind,tungsind,muskelsvind,sælskind,edderkoppespind,vægelsind,ruskind,letsind,hygiejnebind,sørgebind,bogbind,lammeskind,hjernespind,afsind,slangeskind,gazebind,gedeskind,sløvsind,fåreskind,bjørneskind,stivsind,tigerskind,mundbind,ræveskind,ungdomssløvsind,krokodilleskind,vaskeskind,fiskeskind,retsind,egensind,elastikbind,svineskind,pølseskind,helbind,nigerskind,skridtbind,halvbind,pragtbind,brokbind,skarpsind,højsind,vælskbind,franskbind,skødeskind,uldspind,molskind,glavind,springbind,hellæderbind,elsdyrskind,snæversind,ædelsind
3	nte	75	0.00020	69	6	rente,plante,pointe,tante,mente,lunte,mynte,potteplante,finte,livrente,stueplante,realrente,vante,kulbrinte,klinte,lægeplante,dente,guvernante,glente,prydplante,slyngplante,ukrudtsplante,jante,løgplante,strafrente,kulturplante,svovlbrinte,lånerente,bælgplante,trunte,pebermynte,klatreplante,nytteplante,dronte,ågerrente,morarente,skærmplante,grandtante,frøplante,byggerente,overrente,entente,servante,spumante,værtsplante,drivhusplante,akvatinte,kokaplante,bælgvante,legetante,krusemynte,fingervante,karsporeplante,snylteplante,sporeplante,detente,stente,halvtante,tinte,hybente,dag til dag-rente,fjante,elletrunte,maniokplante,spindplante,rådplante,andante,sirplante,ceylonte	testamente,sakramente,regimente,livstestamente,spumante,andante
3	tem	34	0.00020	1	33	totem	system,styresystem,økosystem,solsystem,nervesystem,stem,kvotesystem,centralnervesystem,alarmsystem,operativsystem,lydsystem,reolsystem,flerpartisystem,koordinatsystem,fastprissystem,talsystem,topartisystem,etpartisystem,totem,modulsystem,item,tokammersystem,metersystem,skriftsystem,titalssystem,klippekortsystem,frontsystem,decimalsystem,totalssystem,etkammersystem,tolvtalssystem,decimalklassesystem,duodecimalsystem
3	elt	36	0.00020	11	25	felt,helt,superhelt,antihelt,krigshelt,søhelt,smelt,frihedshelt,spelt,tøffelhelt,sportshelt	felt,telt,oliefelt,magnetfelt,minefelt,krydsfelt,spændingsfelt,synsfelt,fodgængerfelt,fortelt,cirkustelt,førerfelt,virkefelt,emnefelt,skydetelt,søgefelt,kraftfelt,villatelt,ilttelt,iglotelt,tomandstelt,indertelt,kuppeltelt,kulfelt,gåfelt
3	yst	33	0.00019	22	11	lyst,kyst,dyst,virkelyst,ulyst,rejselyst,eventyrlyst,læselyst,livslyst,sexlyst,vellyst,arbejdslyst,spørgelyst,knyst,hævnlyst,ametyst,lærelyst,svenskekyst,ædelyst,kappelyst,vandrelyst,videlyst	bryst,andebryst,kyllingebryst,oksebryst,kalkunbryst,knyst,kalvebryst,gåsebryst,skjortebryst,spidsbryst,kravebryst
3	ere	26	0.00019	26	0	karriere,premiere,barriere,misere,urpremiere,forpremiere,repremiere,sæsonpremiere,gallapremiere,sprogbarriere,snigpremiere,lynkarriere,voliere,kometkarriere,ampere,gondoliere,gruyere,bonbonniere,bajadere,etagere,kostumiere,portiere,bruyere,jardiniere,voltampere,chiffonniere	
3	raf	62	0.00019	62	0	biograf,straf,fotograf,paragraf,fængselsstraf,dødsstraf,koreograf,scenograf,autograf,giraf,graf,formålsparagraf,bødestraf,typograf,filmfotograf,frihedsstraf,geograf,etnograf,radiograf,telegraf,seismograf,amatørfotograf,gummiparagraf,reststraf,demograf,litograf,hæftestraf,kartograf,oceanograf,fonograf,stenograf,disciplinærstraf,pryglestraf,kanonfotograf,pornograf,forvandlingsstraf,paparazzofotograf,ordenshistoriograf,historiograf,løfteparagraf,seraf,kryptograf,leksikograf,bibliograf,kalligraf,serigraf,livsstraf,spektrograf,topograf,epigraf,homograf,xylograf,kardiograf,elektrokardiograf,reprograf,barograf,oscillograf,digraf,drive-in-biograf,termograf,hektograf,palæograf	
3	ræk	48	0.00019	11	37	træk,skræk,gennemtræk,højdeskræk,flyskræk,sceneskræk,tandlægeskræk,vandskræk,stenbræk,tunnelskræk,benbræk	træk,stræk,optræk,modtræk,fællestræk,firehjulstræk,karaktertræk,bræk,betræk,udtræk,skuldertræk,afbræk,hovedtræk,overtræk,gennemtræk,antræk,læderindtræk,navnetræk,personlighedstræk,aftræk,skaktræk,indtræk,særtræk,dynebetræk,snoretræk,fugletræk,præk,pudebetræk,skattetræk,kædetræk,sejtræk,undertræk,remtræk,sukkerovertræk,dyvelsdræk,skånebetræk,underbetræk
3	ark	60	0.00019	43	17	park,mark,nationalpark,slagmark,forlystelsespark,monark,vindmøllepark,bark,patriark,strandpark,vinmark,ødemark,bypark,oligark,bilpark,naturpark,dyrepark,kornmark,græsmark,vildmark,hjernebark,pløjemark,vognpark,brakmark,temapark,kvark,rapsmark,finmark,rugmark,matriark,stubmark,knark,udmark,fjeldmark,missionsmark,klatrepark,egebark,binyrebark,kinabark,naturnationalpark,nyrebark,D-mark,kvillajabark	spark,straffespark,frispark,hjørnespark,regneark,benchmark,udspark,saksespark,målspark,cirkelspark,hark,vristspark,æselspark,hælspark,stilark,indspark,korrekturark
3	ved	64	0.00019	8	56	sved,koldsved,armsved,slangehoved,benved,fodsved,kvalkved,korsved	hoved,baghoved,overhoved,statsoverhoved,brohoved,sprænghoved,dødningehoved,hestehoved,rodehoved,familieoverhoved,brokkehoved,salathoved,æggehoved,kålhoved,brushoved,strubehoved,hvidkålshoved,skvadderhoved,blomkålshoved,fæhoved,høved,snakkehoved,janushoved,brevhoved,torskehoved,barnehoved,vrøvlehoved,rødkålshoved,tossehoved,grødhoved,pibehoved,fjollehoved,hængehoved,fjumrehoved,tonehoved,kerneved,hammerhoved,klynkehoved,oksehoved,smølehoved,sludrehoved,pylrehoved,nussehoved,bjælkehoved,dummerhoved,sjokkehoved,tudehoved,sidehoved,snøvlehoved,skabilkenhoved,skabehoved,pjathoved,skærehoved,kvajhoved,pjokkehoved,klummerhoved
3	rdi	31	0.00019	31	0	værdi,friværdi,markedsværdi,grænseværdi,lejeværdi,underholdningsværdi,grundværdi,signalværdi,merværdi,kursværdi,nytteværdi,symbolværdi,hæmatokritværdi,herlighedsværdi,brugsværdi,affektionsværdi,salgsværdi,brændværdi,middelværdi,tærskelværdi,talværdi,kontantværdi,realværdi,nyværdi,jordværdi,pH-værdi,genkøbsværdi,fuldværdi,k-værdi,nominalværdi,tilbagekøbsværdi	
3	ære	69	0.00018	67	2	lære,affære,atmosfære,kære,pære,sfære,blære,mesterlære,sparepære,tjære,privatsfære,vanære,udenadslære,interessesfære,intimsfære,elpære,udviklingslære,stratosfære,elsparepære,hestepære,evolutionslære,galdeblære,biosfære,kimære,lavenergipære,hørelære,datalære,urinblære,troposfære,naturlære,svømmeblære,malerlære,vranglære,hemisfære,samfundslære,tømrerlære,morallære,mængdelære,gråpære,motorlære,færdselslære,murerlære,ionosfære,arvelighedslære,metodelære,hetære,materialelære,skydelære,sproglære,harmonilære,gudelære,perspektivlære,kromosfære,metallære,hydrosfære,kostlære,litosfære,verselære,megære,LED-pære,værkstedslære,ordlære,pastorallære,virksomhedslære,borelære,ydrelære,grevmoltkepære	velvære,cirkulære
3	ogi	164	0.00018	163	1	teknologi,ideologi,psykologi,økologi,biologi,teologi,trilogi,mytologi,antologi,genteknologi,arkæologi,sociologi,informationsteknologi,bioteknologi,antropologi,geologi,terminologi,kronologi,astrologi,fysiologi,datalogi,filologi,højteknologi,analogi,nanoteknologi,mikrobiologi,gynækologi,farmakologi,neurologi,kosmologi,demagogi,robotteknologi,epidemiologi,molekylærbiologi,patologi,zoologi,etnologi,meteorologi,fænomenologi,immunologi,politologi,anæstesiologi,sexologi,kriminologi,radiologi,onkologi,yogi,ontologi,socialpsykologi,urologi,kardiologi,etymologi,udviklingspsykologi,reumatologi,numerologi,toksikologi,kinesiologi,eskimologi,typologi,kultursociologi,byøkologi,børnepsykologi,ætiologi,morfologi,socialantropologi,topologi,apologi,palæontologi,neuropsykologi,tetralogi,ornitologi,genealogi,dermatologi,neurofysiologi,egyptologi,dybdepsykologi,virologi,gerontologi,psykopatologi,histologi,oftalmologi,odontologi,metodologi,marinbiologi,allergologi,parapsykologi,grafologi,humanbiologi,metrologi,tautologi,symptomatologi,etologi,sprogpsykologi,bakteriologi,gestaltpsykologi,audiologi,cytologi,epistemologi,glaciologi,venerologi,seismologi,lavteknologi,eskatologi,mineralogi,laryngologi,assyriologi,sprogteknologi,folkeetymologi,fraseologi,zoofysiologi,havbiologi,hydrologi,dendrokronologi,embryologi,fonologi,frenologi,semiologi,parasitologi,entomologi,klimatologi,indologi,parodontologi,sinologi,gruppepsykologi,serologi,dialektologi,kristologi,kremlologi,runologi,otologi,ernæringsfysiologi,homologi,teleologi,kulturantropologi,kosmetologi,oceanologi,feminologi,geomorfologi,bromatologi,individualpsykologi,hippologi,osteologi,gemmologi,ufologi,røntgenologi,petrologi,futurologi,haplologi,iktyologi,selenologi,aerologi,herpetologi,vulkanologi,molekylarbiologi,ikonologi,eksperimentalpsykologi,karakterologi,geobiologi,bryologi,limnologi,højhastighedsteknologi,immunbiologi,dendrologi	logi
3	use	27	0.00018	25	2	pause,house,bluse,tænkepause,sluse,frokostpause,muse,kaffepause,ruse,kunstpause,rygepause,spisepause,skjortebluse,menopause,åleruse,tissepause,hypotenuse,berceuse,chartreuse,generalpause,polobluse,charmeuse,russerbluse,V-bluse,mitrailleuse	penthouse,steakhouse
3	egn	74	0.00018	24	50	regn,omegn,hjemegn,kordegn,degn,støvregn,guldregn,styrtregn,monsunregn,kugleregn,sommerregn,slagregn,blåregn,heldagsregn,finregn,vinterregn,meteorregn,øsregn,ruskregn,dagregn,plaskregn,grøderegn,sjaskregn,skylregn	tegn,spørgsmålstegn,hegn,kendetegn,vartegn,lighedstegn,fortegn,kærtegn,udråbstegn,sundhedstegn,livstegn,jagttegn,skrifttegn,læhegn,trådhegn,sygdomstegn,anførselstegn,citationstegn,fisketegn,grænsehegn,hundetegn,raftehegn,træthedstegn,duelighedstegn,jærtegn,elhegn,dødstegn,flethegn,aftegn,sejrstegn,skilletegn,nattegn,minustegn,accenttegn,gradstegn,plustegn,taltegn,jokertegn,V-tegn,opløsningstegn,baltegn,rodtegn,gangetegn,interpunktionstegn,korrekturtegn,lægtehegn,vinkelanførselstegn,et-tegn,punkttegn,blanktegn
3	tol	72	0.00018	68	4	domstol,stol,pistol,talerstol,kørestol,lænestol,maskinpistol,prædikestol,chefstol,direktørstol,liggestol,kontorstol,rullestol,barnestol,klapstol,barstol,hovedstol,autostol,gyngestol,skriftestol,atol,tjenestepistol,folkedomstol,tronstol,sækkestol,pavestol,luftpistol,kurvestol,vandpistol,instruktørstol,særdomstol,gaspistol,guldstol,legetøjspistol,sømpistol,lærestol,armstol,strømpistol,boltpistol,øreklapstol,bispestol,bærestol,splatterpistol,skalstol,stabelstol,limpistol,sprøjtepistol,wienerstol,safaristol,pindestol,gåstol,voldgiftsdomstol,flugtstol,drejestol,elkørestol,vævestol,elevatorstol,chesterfieldstol,gangstol,tremmestol,rokkestol,rottingstol,hæftepistol,windsorstol,malepistol,bådsmandsstol,dæksstol,nodestol	chatol,sludrechatol,mentol,sorbitol
3	lig	27	0.00017	24	3	bolig,ejerbolig,andelsbolig,ældrebolig,plejebolig,lejebolig,ungdomsbolig,flig,privatbolig,embedsbolig,fritidsbolig,tjenestebolig,studiebolig,seniorbolig,æresbolig,tagbolig,fribolig,funktionærbolig,forpagterbolig,gartnerbolig,kollektivbolig,nødbolig,fleksbolig,kappeflig	forlig,vejrlig,kludetæppeforlig
3	ejl	57	0.00017	26	31	fejl,stavefejl,fodfejl,regnefejl,hjertefejl,skønhedsfejl,trykfejl,dobbeltfejl,slåfejl,begynderfejl,kromosomfejl,sjuskefejl,talefejl,bygningsfejl,skrivefejl,tastefejl,funktionsfejl,byggefejl,plejl,vævefejl,materialefejl,huskefejl,bævergejl,kvejl,tegnfejl,oversætterfejl	spejl,sejl,bakspejl,sidespejl,vandspejl,gejl,storsejl,troldspejl,solsejl,vindspejl,grundvandsspejl,forsejl,bramsejl,agterspejl,hulspejl,genspejl,topsejl,råsejl,makeupspejl,oversejl,ganesejl,toiletspejl,førerspejl,stagsejl,skråsejl,bomsejl,øjenspejl,konsolspejl,latinersejl,mundspejl,drejl
3	rum	74	0.00017	5	69	trummerum,rørdrum,durum,lirumlarum,futurum	centrum,mellemrum,forum,tidsrum,bagagerum,råderum,tomrum,luftrum,byrum,serum,kirkerum,pusterum,frirum,spillerum,maskinrum,kælderrum,alrum,verdensrum,hulrum,fixerum,fællesrum,debatforum,beskyttelsesrum,lastrum,handskerum,baderum,himmelrum,albuerum,monstrum,bederum,kølerum,prøverum,legerum,lagerrum,manøvrerum,fyrrum,hjerterum,vaskerum,uderum,handlerum,sømmerum,venterum,husrum,kulturcentrum,vådrum,pulterrum,chatrum,hobbyrum,chatforum,fryserum,livsrum,skyllerum,sikringsrum,skillerum,operatørrum,lirumlarum,brum,førerrum,sandhedsserum,puslerum,futurum,dekorum,metrum,neutrum,backstagerum,VIP-rum,pakrum,blodserum,køkken-alrum
3	læg	58	0.00017	2	56	klæg,flæg	indlæg,anlæg,oplæg,tillæg,belæg,sagsanlæg,pålæg,forlæg,rensningsanlæg,klimaanlæg,overlæg,stereoanlæg,renseanlæg,arveanlæg,udlæg,forbrændingsanlæg,betalingsanlæg,spejlæg,køleanlæg,navigationsanlæg,kajanlæg,fællesantenneanlæg,genetillæg,samtaleanlæg,kvalifikationstillæg,centralvarmeanlæg,trusseindlæg,bødeforelæg,nødkaldeanlæg,nattillæg,modindlæg,kaldeanlæg,stedtillæg,udetillæg,surroundanlæg,karaokeanlæg,ulempetillæg,genbrugsanlæg,smørepålæg,ammeindlæg,fodindlæg,smudstillæg,offshoreanlæg,navnetillæg,wienerlæg,klæg,gålæg,blødtvandsanlæg,havanlæg,underlæg,personsøgeanlæg,fugtighedsanlæg,hi-fi-anlæg,islæg,flæg,fremlæg
3	ærd	32	0.00017	14	18	adfærd,velfærd,færd,dyrevelfærd,fremfærd,pilgrimsfærd,retfærd,ligfærd,jordefærd,bålfærd,vikingefærd,gravfærd,voldsfærd,hjemfærd	velfærd,værd,sværd,selvværd,dyrevelfærd,folkefærd,genfærd,ligeværd,mindreværd,menneskeværd,lyssværd,damoklessværd,flammesværd,bedreværd,mereværd,slagsværd,tohåndssværd,egenværd
3	liv	39	0.00017	0	39		erhvervsliv,privatliv,arbejdsliv,menneskeliv,kulturliv,natteliv,samliv,sexliv,voksenliv,byliv,underliv,dagligliv,følelsesliv,fugleliv,friluftsliv,åndsliv,dobbeltliv,seksualliv,folkeliv,børneliv,efterliv,sjæleliv,udeliv,kønsliv,hundeliv,selskabsliv,hjemmeliv,jordeliv,driverliv,studenterliv,skyggeliv,rakkerliv,kristenliv,københavnerliv,snøreliv,egetliv,stilleliv,eneboerliv,herreliv
3	rog	66	0.00017	16	50	krog,afkrog,øjenkrog,skammekrog,krinkelkrog,hyggekrog,fiskekrog,trækkrog,spisekrog,grog,pirog,ravnekrog,fangstkrog,dejkrog,skonrog,stormkrog	sprog,ordsprog,kropssprog,fremmedsprog,formsprog,skrog,billedsprog,fagsprog,skriftsprog,tegnsprog,talesprog,dannebrog,originalsprog,andetsprog,hovedsprog,drog,valgsprog,programmeringssprog,nysprog,dagligsprog,arbejdssprog,frisprog,nationalsprog,kunstsprog,æbleskrog,nabosprog,skibsskrog,kancellisprog,fingersprog,rigssprog,regionalsprog,standardsprog,ursprog,grundsprog,klarsprog,almensprog,omgangssprog,barnesprog,plansprog,kreolsprog,modersprog,vulgærsprog,metasprog,målsprog,gåseskrog,pidginsprog,klikesprog,objektsprog,gestussprog,udgangssprog
3	mst	62	0.00016	62	0	blomst,overenskomst,indkomst,ankomst,overførselsindkomst,forekomst,hjemkomst,herkomst,sammenkomst,velkomst,fremkomst,genkomst,mellemkomst,sommerblomst,tilbagekomst,årsindkomst,hyldeblomst,opkomst,adkomst,tilsynekomst,klokkeblomst,bruttoindkomst,mellemindkomst,realindkomst,kornblomst,bekomst,stedmoderblomst,tilskadekomst,lavindkomst,nationalindkomst,tilkomst,isblomst,ærteblomst,socialindkomst,smørblomst,kirsebærblomst,nedkomst,passionsblomst,bruttofaktorindkomst,bortkomst,evighedsblomst,kurvblomst,højindkomst,hawaiiblomst,kamilleblomst,merindkomst,jasminblomst,fløjlsblomst,porcelænsblomst,flueblomst,læbeblomst,skærmblomst,nulindkomst,gæslingeblomst,tøffelblomst,udkomst,hjerteblomst,skiveblomst,B-indkomst,skalaindkomst,A-indkomst,tilstedekomst	
3	nal	52	0.00016	33	19	kanal,journal,terminal,original,kardinal,radiokanal,marginal,busterminal,rentemarginal,proportional,diagonal,annal,sygejournal,tårekanal,postterminal,tarmkanal,godsterminal,fordøjelseskanal,udenrigsterminal,skærmterminal,fragtterminal,indenrigsterminal,mellemproportional,ferskvareterminal,modejournal,dataterminal,professional,kontubernal,trækkanal,public service-kanal,godsbaneterminal,mave-tarm-kanal,aboriginal	signal,arsenal,tribunal,lyssignal,nødsignal,startsignal,alarmsignal,pausesignal,røgsignal,urinal,stopsignal,mobilsignal,kaldesignal,klarsignal,urosignal,konjunktional,virginal,SOS-signal,nominal
3	int	30	0.00016	16	14	klint,labyrint,brint,joint,flint,splint,hyacint,absint,teint,granatsplint,mint,kvint,forint,plint,embonpoint,spearmint	point,procentpoint,print,sprint,checkpoint,maksimumpoint,strafpoint,kvint,honnørpoint,strint,hint,embonpoint,petitpoint,udprint
3	tof	39	0.00016	0	39		stof,brændstof,sprængstof,kvælstof,råstof,næringsstof,tilsætningsstof,fedtstof,grundstof,giftstof,antistof,farvestof,kulstof,læsestof,foderstof,kunststof,affaldsstof,smagsstof,forsidestof,aromastof,sødestof,sporstof,tørstof,kontraststof,fyldstof,smitstof,bitterstof,æggehvidestof,urinstof,petitstof,garvestof,forbindsstof,lærestof,lærredsstof,jerseystof,røbestof,cellstof,formstof,ostestof
3	lar	20	0.00016	11	9	dollar,fødselar,jubilar,formular,trylleformular,petrodollar,galar,talar,velar,alveolar,eurodollar	eksemplar,pragteksemplar,vokabular,kevlar,anmeldereksemplar,okular,frieksemplar,mandagseksemplar,originaleksemplar
3	rag	34	0.00015	1	33	drag	bidrag,foredrag,brag,fradrag,uddrag,afdrag,åndedrag,bedrag,vrag,skattefradrag,drag,arbejdsmarkedsbidrag,selvbedrag,børnebidrag,bundfradrag,højdedrag,opdrag,personfradrag,bakkedrag,sammendrag,skibsvrag,kørselsfradrag,underholdsbidrag,engdrag,synsbedrag,ringvrag,nervevrag,nakkedrag,tordenbrag,sansebedrag,AUD-bidrag,am-bidrag,ATP-bidrag
3	rop	31	0.00015	29	2	krop,blodprop,trop,prop,overkrop,bundprop,trafikprop,fortrop,strop,øreprop,filantrop,misantrop,underkrop,korkprop,bagtrop,bagkrop,hidsigprop,skulderstrop,forkrop,patentprop,stikprop,stødtrop,spaghettistrop,heliotrop,dovenkrop,skænkeprop,blindprop,stænkeprop,blindstikprop	drop,morfindrop
3	røm	24	0.00015	24	0	drøm,strøm,pengestrøm,slipstrøm,understrøm,drengedrøm,talestrøm,malstrøm,ønskedrøm,dagdrøm,luftstrøm,ordstrøm,vekselstrøm,modstrøm,jævnstrøm,jetstrøm,stærkstrøm,svagstrøm,kørestrøm,fejlstrøm,nødstrøm,ångstrøm,induktionsstrøm,krybestrøm	
3	end	29	0.00015	26	3	weekend,trend,svend,følgesvend,ungersvend,lejesvend,dimittend,polterabend,murersvend,malersvend,vedbend,tømrersvend,dividend,bagersvend,friweekend,korend,pebersvend,smedesvend,håndværkssvend,revalidend,mestersvend,addend,minuend,subtrahend,blend,happy end	langrend,sammenrend,rend
3	yld	20	0.00015	16	4	skyld,hyld,fyld,uskyld,grundskyld,byld,medskyld,druehyld,opfyld,tandbyld,pestbyld,brandbyld,tarteletfyld,syld,ejendomsskyld,omeletfyld	fyld,opfyld,tarteletfyld,omeletfyld
3	rre	39	0.00015	36	3	herre,bygherre,sejrherre,porre,krigsherre,kammerherre,spærre,barre,startspærre,snurre,aborre,koloniherre,feltherre,kærre,guldbarre,bordherre,kurre,snerre,dampspærre,tempelherre,friherre,burre,lensherre,oldenborre,rådsherre,stamherre,engsnarre,burresnerre,slikporre,hvarre,thespiskærre,glashvarre,tørre,tangsnarre,enevoldsherre,kanelsnurre	spærre,dampspærre,parterre
3	rte	36	0.00015	31	5	smerte,skjorte,tærte,brystvorte,eskorte,vorte,tryksværte,skovmandsskjorte,ledsmerte,kønsvorte,sværte,fodvorte,hawaiiskjorte,skosværte,natskjorte,kohorte,poloskjorte,myrte,kerte,karte,storskjorte,sejrsskjorte,sjuskedorte,løjtnantshjerte,vokskerte,commedia dell'arte,nature morte,sachertærte,gangvorte,stempelsværte,lændesmerte	hjerte,pianoforte,sovehjerte,artiskokhjerte,karte
3	vne	31	0.00015	29	2	evne,konkurrenceevne,revne,ydeevne,erhvervsevne,lederevne,funktionsevne,bæreevne,indlæringsevne,fatteevne,lasteevne,reaktionsevne,åndsevne,avne,læseevne,sugeevne,skaberevne,synsevne,handleevne,tænkeevne,spireevne,fremstillingsevne,refleksionsevne,udtryksevne,bageevne,føleevne,ledeevne,virkeevne,strækevne	stævne,købestævne
3	man	47	0.00015	47	0	roman,narkoman,norman,gentleman,kriminalroman,osman,ironman,shaman,ludoman,pyroman,handyman,kærlighedsroman,samtidsroman,nøgleroman,stuntman,tryghedsnarkoman,slægtsroman,dannelsesroman,talisman,stiknarkoman,knaldroman,udviklingsroman,murstensroman,generationsroman,detektivroman,kollektivroman,lægeroman,ottoman,nymfoman,dokumentarroman,fantasyroman,kleptoman,discman,mytoman,heman,føljetonroman,brahman,trivialroman,erotoman,skælmeroman,dolman,biblioman,eufoman,megaloman,science fiction-roman,jegroman,tendensroman	
3	tar	33	0.00014	32	1	kommentar,guitar,hektar,dokumentar,vegetar,star,tatar,nektar,proletar,elguitar,notar,luftguitar,dignitar,basguitar,sitar,slideguitar,mavekatar,steelguitar,unitar,citar,komplementar,mandatar,katar,realkommentar,depositar,skedekatar,halskatar,tarmkatar,legatar,fleksitar,hawaiiguitar,pescetar	inventar
3	ast	59	0.00014	42	17	kontrast,last,hast,mast,plast,ballast,entusiast,gymnast,tast,knast,overlast,fantast,trælast,gast,toast,bast,gymnasiast,sendemast,elmast,kvast,tørlast,cineast,rast,fusentast,skumplast,piletast,pudderkvast,orlogsgast,parisertoast,stormast,pæderast,cowboytoast,dækslast,alabast,signalmast,slettetast,fokkemast,rettetast,podcast,outcast,returtast,shifttast	afkast,udkast,kast,plast,øjekast,straffekast,stenkast,opkast,indkast,spydkast,diskoskast,frikast,skumplast,terningekast,alabast,målkast,podcast
3	kum	23	0.00014	3	20	flødeskum,basilikum,filosofikum	publikum,antibiotikum,skum,flødeskum,lokum,teknikum,narkotikum,stampublikum,pædagogikum,unikum,barberskum,afskum,talkum,afrodisiakum,sæbeskum,tonikum,periodikum,merskum,kemoterapeutikum,praktikum
3	ice	39	0.00014	35	4	service,juice,borgerservice,servitrice,police,kundeservice,novice,læserservice,ekspeditrice,appelsinjuice,softice,æblejuice,roomservice,forsikringspolice,matrice,malice,benefice,tomatjuice,defektrice,limejuice,montrice,patrice,orangejuice,protektrice,kaprice,brikjuice,frontispice,inspektrice,aktrice,public service,pizzaslice,slice,tast selv-service,kollektrice,slushice	service,hospice,engangsservice,slice
3	ans	94	0.00014	93	1	dans,sans,instans,substans,dominans,relevans,glans,tjans,krans,folkedans,observans,stimulans,retsinstans,sankthans,lugtesans,adventskrans,resonans,mavedans,kædedans,linedans,pardans,rosenkrans,synssans,standarddans,stråleglans,ankeinstans,diskrepans,følesans,dissonans,stedsans,smagssans,prægnans,dødedans,afglans,sportsdans,proportionssans,trommedans,slapsvans,højglans,ordenssans,appelinstans,kinddans,vaniljekrans,svans,pomerans,brillans,stepdans,krigsdans,tranedans,runddans,konstans,redundans,signifikans,virkelighedssans,loppetjans,impedans,varians,fukssvans,irrelevans,orienteringssans,ordonnans,perlekrans,nøgendans,resistans,piphans,tornekrans,højfinans,konkordans,sejrskrans,stopdans,sporsans,sværddans,tolerans,protuberans,sanktvejtsdans,æggedans,barfodsdans,turdans,borddans,induktans,pralhans,invarians,kontradans,luminans,klodshans,assonans,reluktans,ukurans,konsonans,blyglans,tryksans,konduktans,galfrans	afrikaans
3	rve	54	0.00014	54	0	farve,reserve,nerve,kurve,hudfarve,larve,valutareserve,hårfarve,formkurve,pastelfarve,verve,efterve,arve,skærve,pangfarve,klangfarve,kontrastfarve,grundfarve,modefarve,vandfarve,frugtfarve,harve,oliefarve,synsnerve,bundfarve,høstfarve,solkurve,primærfarve,balancenerve,limfarve,signalfarve,komplementærfarve,trykfarve,indlæringskurve,plantefarve,dækfarve,iskiasnerve,spektralfarve,målerlarve,lokalfarve,lugtenerve,laksefarve,sekundærfarve,tallerkenharve,spartelfarve,amarantfarve,rødarve,gausskurve,hoffarve,lasurfarve,krapfarve,bækarve,bremselarve,purpurfarve	
3	red	49	0.00014	25	24	fred,bred,ørred,havørred,verdensfred,ufred,søbred,flodbred,borgfred,strandbred,sjælefred,husfred,gravfred,regnbueørred,vejbred,bækørred,fjeldørred,separatfred,hårsbred,lakseørred,håndsbred,fodsbred,yderred,damørred,inderred	helbred,lærred,skred,jordskred,herred,århundred,sneskred,sækkelærred,stenskred,hørlærred,jernhelbred,lagenlærred,hofteskred,stemmeskred,hårsbred,ostelærred,fjeldskred,smergellærred,silkelærred,malerlærred,stræklærred,bredlærred,tvistlærred,hundred
3	rev	40	0.00014	0	40		brev,læserbrev,nyhedsbrev,pantebrev,drev,koralrev,overdrev,svendebrev,gældsbrev,gækkebrev,kærestebrev,ejerpantebrev,hyrdebrev,næringsbrev,takkebrev,følgebrev,svarbrev,sælgerpantebrev,kædebrev,gavebrev,rykkerbrev,afladsbrev,tebrev,kongebrev,økonomibrev,borgerbrev,fragtbrev,skadesløsbrev,ekspresbrev,lærebrev,klipperev,lydbrev,bilbrev,B-brev,DVD-drev,poste restante-brev,værdibrev,A-brev,snekkedrev,e-brev
3	eje	70	0.00014	41	29	leje,husleje,pleje,dagpleje,ældrepleje,hjemmepleje,reje,sygepleje,tandpleje,familiepleje,retspleje,fjordreje,hjemmesygepleje,hudpleje,gurkemeje,menighedspleje,kundepleje,døgnpleje,udleje,yngelpleje,tigerreje,imagepleje,fremleje,akeleje,skoletandpleje,formuepleje,vildtpleje,fodpleje,kurspleje,kropspleje,hårpleje,barnepleje,hestereje,skalmeje,ostereje,kabbeleje,langtidsleje,engkabbeleje,boksleje,dagleje,pil selv-reje	leje,samleje,dødsleje,færgeleje,toneleje,fiskerleje,prisleje,særeje,fælleseje,folkeeje,selveje,allemandseje,sygeleje,privateje,kugleleje,sengeleje,flodleje,stemmeleje,stemningsleje,stilleje,mellemleje,sameje,sideleje,statseje,medeje,smertensleje,nationaleje,almeneje,kulleje
3	ise	52	0.00014	49	3	krise,vise,spise,ekspertise,devise,mayonnaise,entreprise,radise,lise,brise,frise,folkevise,merchandise,identitetskrise,reprise,bearnaise,flise,midtvejskrise,franchise,totalentreprise,vuggevise,revyvise,markise,klimakrise,remise,hollandaise,skillingsvise,drikkevise,chemise,kinaradise,midtlivskrise,flittiglise,vægflise,underentreprise,prise,bordelaise,smædevise,tæppeflise,søbrise,bise,muffedise,kæmpevise,vokalise,nidvise,skæmtevise,vinylflise,brudflise,snapreprise,portechaise	merchandise,cruise,broderie anglaise
3	jse	33	0.00013	33	0	rejse,afrejse,rundrejse,udlandsrejse,charterrejse,indrejse,bryllupsrejse,studierejse,udrejse,pakkerejse,tidsrejse,jomfrurejse,gennemrejse,udenlandsrejse,tjenesterejse,grupperejse,dagsrejse,blåmejse,sprogrejse,bortrejse,selskabsrejse,mejse,spætmejse,billigrejse,sumpmejse,sortmejse,pungmejse,topmejse,fyrremejse,dagrejse,henrejse,gråmejse,lapmejse	
3	uld	67	0.00013	53	14	håndfuld,spiseskefuld,teskefuld,mundfuld,bomuld,muld,skefuld,savsmuld,røvfuld,busfuld,endefuld,glasuld,mineraluld,himmerigsmundfuld,tankfuld,skovlfuld,spandfuld,hattepuld,nævefuld,stenuld,hatfuld,kæruld,skålfuld,favnfuld,træuld,puld,bakskuld,papiruld,posefuld,tallerkenfuld,grydefuld,vognfuld,kopfuld,kurvfuld,ståluld,sækfuld,merinould,skudefuld,kameluld,redefuld,vinterbomuld,barneskefuld,celluld,krøluld,skydebomuld,kradsuld,spadefuld,bøttefuld,shetlandsuld,topskefuld,æskefuld,flokuld,heluld	guld,bomuld,kuld,savsmuld,bladguld,huld,hvidguld,smuld,rødguld,vinterbomuld,skydebomuld,læsfuld,flitterguld,fadfuld
3	rik	62	0.00013	58	4	fabrik,brik,retorik,drik,prik,lyrik,rubrik,strik,maskinfabrik,klædefabrik,læskedrik,historik,cementfabrik,motorik,skiderik,møtrik,obstetrik,tobaksfabrik,fulderik,energidrik,dominobrik,metaforik,underrubrik,konservesfabrik,skakbrik,finmotorik,hønsestrik,metrik,filetfabrik,kemifabrik,andrik,sportsdrik,polkaprik,kombinatorik,refleksbrik,søgehistorik,ølbrik,trikotagefabrik,mellemrubrik,panegyrik,grovmotorik,juicebrik,fændrik,gudedrik,nøglebrik,dovendidrik,krummerik,trævarefabrik,gavstrik,udeladelsesprik,fenrik,excentrik,majdrik,smørebrik,fjollerik,duerik,geoelektrik,tøveprik	prik,strik,hønsestrik,vrik
3	ård	34	0.00013	34	0	gård,kirkegård,banegård,hovedbanegård,præstegård,herregård,sognegård,baggård,skolegård,vingård,bondegård,hovedgård,købmandsgård,skærgård,slægtsgård,fattiggård,hønsegård,ødegård,avlsgård,forgård,ladegård,kravlegård,kongsgård,bispegård,godsbanegård,klostergård,gæstgivergård,lystgård,urtegård,bilkirkegård,ormegård,borggård,fæstegård,fædrenegård	
3	ugt	47	0.00013	47	0	frugt,flugt,bugt,lugt,udflugt,fugt,tilflugt,peberfrugt,himmelflugt,rodfrugt,slugt,grapefrugt,citrusfrugt,utugt,virkelighedsflugt,kapitalflugt,tugt,hjerneflugt,sandflugt,bælgfrugt,passionsfrugt,faneflugt,limefrugt,stenfrugt,bærfrugt,sydfrugt,heldagsudflugt,skatteflugt,nedfaldsfrugt,fugleflugt,kiwifrugt,glideflugt,tankeflugt,råfrugt,vellugt,endagsudflugt,kærlighedsfrugt,kirketugt,stjernefrugt,selvtugt,ildelugt,hustugt,mandstugt,kapselfrugt,brødfrugt,spaltefrugt,dugt	
3	sis	23	0.00013	22	1	praksis,basis,skepsis,dosis,indlandsis,retspraksis,overdosis,oasis,psoriasis,nemesis,amanuensis,domspraksis,katarsis,sodavandsis,apsis,franchisebasis,delebasis,elefantiasis,arsis,deiksis,joint venture-basis,sepsis	chassis
3	tek	22	0.00013	0	22		bibliotek,apotek,diskotek,glyptotek,hovedbibliotek,folkebibliotek,kartotek,børnebibliotek,skolebibliotek,musikbibliotek,forskningsbibliotek,kommunebibliotek,mediatek,videotek,chartek,plasticchartek,fototek,pinakotek,legetek,fonotek,programbibliotek,hypotek
3	nje	44	0.00013	44	0	linje,retningslinje,bundlinje,sidelinje,skillelinje,frontlinje,kastanje,kystlinje,skudlinje,baglinje,tidslinje,mållinje,midterlinje,brynje,sigtelinje,brudlinje,fugleflugtslinje,pinje,ringbrynje,luftlinje,demarkationslinje,byggelinje,ganglinje,hestekastanje,banje,datolinje,fødelinje,grundlinje,verselinje,diskretionslinje,bikinilinje,bølgelinje,tallinje,mønje,mandslinje,globelinje,lodlinje,ildlinje,vigelinje,vaterlinje,skrålinje,nullinje,siksaklinje,horisontallinje	
3	nit	35	0.00012	15	20	granit,christianit,unit,eternit,yemenit,skibonit,sunnit,masonit,nibenit,rødbynit,maribonit,sundbynit,nørresundbynit,ebonit,sæbynit	gennemsnit,afsnit,snit,udsnit,kejsersnit,tilsnit,zenit,træsnit,tværsnit,linoleumssnit,keglesnit,indsnit,dagafsnit,guldsnit,længdesnit,skriftsnit,pinsesnit,finit,infinit,tandsnit
3	ogn	74	0.00012	71	3	vogn,campingvogn,kampvogn,barnevogn,sportsvogn,varevogn,lastvogn,sporvogn,undervogn,pølsevogn,skurvogn,hestevogn,togvogn,folkevogn,kassevogn,mandskabsvogn,klapvogn,rogn,hyrevogn,tankvogn,fotovogn,rustvogn,torskerogn,sidevogn,blokvogn,sættevogn,trækvogn,godsvogn,personvogn,påhængsvogn,servicevogn,panservogn,sovevogn,skraldevogn,sækkevogn,jernbanevogn,kreaturvogn,vandvogn,kranvogn,spisevogn,stigevogn,teltvogn,prærievogn,flyttevogn,kølevogn,dukkevogn,sendevogn,hollændervogn,bivogn,pejlevogn,skolevogn,liggevogn,tipvogn,ledsagevogn,kapervogn,brugtvogn,fladvogn,skovvogn,gøglervogn,optagevogn,venusvogn,fragtvogn,trillevogn,pakvogn,trolleyvogn,topersonersvogn,ponyvogn,bogievogn,enejersvogn,firepersonersvogn,enspændervogn	sogn,landsogn,annekssogn
3	tøj	76	0.00012	3	73	støj,trafikstøj,dækstøj	værktøj,køretøj,legetøj,fartøj,undertøj,vasketøj,fodtøj,styretøj,sengetøj,overtøj,slagtøj,børnetøj,syltetøj,sølvtøj,modetøj,badetøj,fyrtøj,rumfartøj,regntøj,motorkøretøj,dametøj,bentøj,nattøj,herretøj,strikketøj,stentøj,fiskefartøj,udrykningskøretøj,genbrugstøj,seletøj,utøj,snakketøj,lertøj,lystfartøj,mærketøj,skitøj,køkkentøj,fritidstøj,mundtøj,bæltekøretøj,luftfartøj,hovedtøj,skiftetøj,stangtøj,matrostøj,sytøj,camouflagetøj,snavsetøj,dukketøj,mandetøj,bagtøj,kobbertøj,troldtøj,ventetøj,skiundertøj,stadstøj,termotøj,skotøj,låsetøj,skrivetøj,tyttebærsyltetøj,strygetøj,kyssetøj,udetøj,lukketøj,olietøj,dækketøj,hækletøj,andendagstøj,kadettøj,væggetøj,alliancesyltetøj,unisextøj
3	idt	20	0.00012	0	20		skridt,fremskridt,mareridt,skidt,tilbageskridt,kridt,ridt,stormskridt,syvmileskridt,skoleridt,kæmpeskridt,skrivekridt,tavlekridt,pastelkridt,blyhvidt,zinkhvidt,rødkridt,blegekridt,parforceridt,sortkridt
3	ods	25	0.00012	6	19	trods,klods,stopklods,byggeklods,bremseklods,lods	gods,klods,tankegods,arvegods,stykgods,vraggods,hittegods,tyvegods,fællesgods,rejsegods,flyttegods,støbegods,jordegods,krongods,fragtgods,returgods,transitgods,tempergods,ilgods
3	nik	60	0.00012	60	0	teknik,kronik,klinik,panik,elektronik,mekanik,kvantemekanik,botanik,privatklinik,massageklinik,sputnik,tandklinik,dyreklinik,fødeklinik,arsenik,biomekanik,skadeklinik,sparketeknik,smerteklinik,byggeteknik,kannik,genteknik,eugenik,bioteknik,beatnik,harmonik,spørgeteknik,akutklinik,køleteknik,finmekanik,pyroteknik,geoteknik,fodklinik,elektroteknik,laboratorieteknik,trykketeknik,fannik,teleteknik,medikoteknik,tektonik,poliklinik,optageteknik,bygningsteknik,taleteknik,tandteknik,mnemoteknik,symfonik,psykoteknik,polyteknik,tracerteknik,bølgemekanik,kemoteknik,kryoteknik,økumenik,hydroteknik,bionik,diatonik,galvanoteknik,geobotanik,hydromekanik	
3	vej	54	0.00012	54	0	motorvej,landevej,udvej,hovedvej,omvej,ringvej,genvej,skolevej,villavej,levevej,afvej,indfaldsvej,omfartsvej,kystvej,søvej,luftvej,smutvej,sidevej,markvej,mælkevej,bagvej,skillevej,motortrafikvej,korsvej,vildvej,middelvej,tværvej,kommandovej,mellemvej,alfarvej,hjemvej,transportvej,bivej,hulvej,smittevej,vintervej,tilkørselsvej,tilbagevej,stikvej,motorringvej,udfaldsvej,stillevej,næringsvej,køkkenvej,brandvej,privatvej,landvej,krogvej,støvvej,fjerdingvej,tilfartsvej,nødudvej,to minus en-vej,serpentinevej	
3	gle	76	0.00012	74	2	nøgle,single,kugle,knogle,jungle,kegle,ugle,halvkugle,krystalkugle,fordelingsnøgle,kogle,kringle,øgle,nagle,jingle,eagle,kanonkugle,krudtugle,platugle,igle,beagle,svensknøgle,rangle,slørugle,natugle,strigle,kæmpeøgle,grankogle,hornugle,romkugle,skruenøgle,billardkugle,sneugle,flyveøgle,startnøgle,mølkugle,hegle,marmorkugle,skagle,skiftenøgle,fodrodsknogle,topnøgle,universalnøgle,himmelkugle,høgeugle,riffelkugle,galopkringle,rørknogle,kroketkugle,perleugle,fyrrekogle,revolverkugle,kommenskringle,fastnøgle,skraldenøgle,unbrakonøgle,waleskringle,G-nøgle,altnøgle,diskantnøgle,F-nøgle,bratschnøgle,telefonnøgle,dyknagle,C-nøgle,sekskantnøgle,kofilnagle,laplandsugle,rettenøgle,tårnugle,dum-dum-kugle,USB-nøgle,krydsnøgle,basnøgle	nøgle,garnnøgle
3	ose	95	0.00012	95	0	pose,diagnose,prognose,rose,mose,plasticpose,glose,tuberkulose,sovepose,psykose,symbiose,sklerose,plastpose,hypnose,lønningspose,hose,godtepose,narkose,mølpose,neurose,vildmose,metamorfose,vindrose,bærepose,glukose,fibrose,julerose,osteoporose,paradentose,stokrose,højmose,skraldepose,cellulose,papirspose,mimose,ispose,mulepose,apoteose,laktose,ligpose,tepose,klitrose,angstneurose,tørvemose,massepsykose,myose,papirpose,vejrprognose,trombose,osmose,bonderose,asbestose,fruktose,cirrose,valgprognose,slyngrose,viskose,mononukleose,nekrose,zoonose,differentialdiagnose,stegepose,kompasrose,bilharziose,vindpose,nøkkerose,lagenpose,skose,levercirrose,kørepose,hedemose,alperose,buketrose,arteriosklerose,traktose,maltose,grænsepsykose,silikose,terose,kolostomipose,mosrose,angstpsykose,tuberose,krystallose,jerikorose,remontantrose,avitaminose,kæbepose,spotteglose,endometriose,koronartrombose,fjerpose,skrofulose,borreliose,pariserrose	
3	net	56	0.00012	23	33	planet,magnet,klarinet,marionet,vignet,sonet,bajonet,publikumsmagnet,krebinet,kastagnet,elektromagnet,småplanet,dværgplanet,nonet,lorgnet,kornet,beignet,biplanet,tilforordnet,valgtilforordnet,stanglorgnet,eksoplanet,signet	internet,sikkerhedsnet,vejnet,kabinet,fibernet,intranet,ledningsnet,telefonnet,hybridnet,fastnet,rodnet,fiskenet,kabelnet,telenet,myggenet,bredbåndsnet,rædselskabinet,forhandlernet,trådnet,spejlkabinet,datanet,sidenet,skyggekabinet,vokskabinet,stinet,spinet,moskitonet,lysnet,ekstranet,signet,separatkabinet,bobinet,drivnet
3	ben	80	0.00012	7	73	stræben,stankelben,hoben,rødben,paraben,indgriben,kløben	våben,atomvåben,flyvevåben,skydevåben,masseødelæggelsesvåben,luftvåben,ribben,koben,højreben,håndvåben,bagben,leben,kernevåben,skinneben,kraveben,venstreben,sideben,automatvåben,hyben,elfenben,firben,kindben,stilleben,bukseben,forben,flueben,lårben,slagvåben,byvåben,kødben,brystben,træben,støtteben,bordben,tusindben,stankelben,rigsvåben,mordvåben,stoleben,vingeben,fiskeben,stikvåben,haleben,nøgleben,skamben,kæbeben,hofteben,revelsben,stikkelsbærben,håndskydevåben,marvben,sildeben,spoleben,korsben,næseben,lamseben,ønskeben,pandeben,hælben,albueben,isseben,skræmmevåben,kløben,smalben,a-våben,stødvåben,siben,hugvåben,smaragdfirben,paraben,vinkelben,antiraketvåben,skankeben
3	ken	48	0.00012	28	20	tallerken,ørken,frøken,medvirken,prædiken,fersken,hjertebanken,lækkerbisken,snorken,stenørken,moralprædiken,desserttallerken,sidetallerken,gardinprædiken,udørken,omflakken,øsken,grønsisken,dommedagsprædiken,genopdukken,sisken,dækketallerken,plesken,præken,tintallerken,røsken,saltørken,froprædiken	køkken,bækken,storkøkken,folkekøkken,skolekøkken,centralkøkken,udekøkken,gadekøkken,tekøkken,spisekøkken,grovkøkken,feltkøkken,dækken,elementkøkken,hestedækken,flykøkken,nyrebækken,stormkøkken,flyvekøkken,skabilken
3	rgi	27	0.00012	27	0	energi,allergi,kirurgi,vindenergi,synergi,solenergi,dramaturgi,atomenergi,plastikkirurgi,liturgi,bioenergi,ortopædkirurgi,bølgeenergi,lavenergi,hjertekirurgi,neurokirurgi,fusionsenergi,fysiurgi,nikkelallergi,thoraxkirurgi,metallurgi,glutenallergi,mikrokirurgi,sammedagskirurgi,letargi,råenergi,genkirurgi	
3	fte	44	0.00012	5	39	vifte,hofte,tofte,rafte,kofte	løfte,årsskifte,skifte,generationsskifte,hæfte,valgløfte,systemskifte,kursskifte,stofskifte,årtusindeskifte,sporskifte,ejerskifte,jobskifte,vagtskifte,hamskifte,replikskifte,tronskifte,kønsskifte,skæfte,århundredeskifte,formandsskifte,månedsskifte,sædskifte,kuponhæfte,stilehæfte,mageskifte,kyskhedsløfte,tavshedsløfte,fodskifte,rollehæfte,skrifte,ordskifte,trosskifte,løberskifte,kollegiehæfte,øvehæfte,indgifte,glosehæfte,kopskifte
3	tue	47	0.00012	47	0	stue,skadestue,vuggestue,tegnestue,statue,dagligstue,spisestue,legestue,varmestue,udestue,julestue,konfirmandstue,opholdsstue,badstue,systue,havestue,myretue,slyngelstue,enestue,rytterstatue,vinstue,jættestue,krostue,frokoststue,kaffestue,pejsestue,mindestue,fødestue,hospitalsstue,sygestue,forstue,fællesstue,vinkelstue,vævestue,storstue,skrivestue,skænkestue,samlingsstue,folkestue,flersengsstue,gildestue,stadsestue,tosengsstue,betjentstue,belægningsstue,sektionsstue,borgestue	
3	til	37	0.00012	34	3	stil,livsstil,ventil,skrivestil,sikkerhedsventil,fristil,pastil,halspastil,kancellistil,rokokostil,rundbuestil,tormentil,lakridspastil,termostatventil,klunkestil,potentil,kvartil,telegramstil,referatstil,bygningsstil,fraktil,postil,almuestil,pistil,nautil,saltpastil,biedermeierstil,stopventil,art deco-stil,topventil,gåsepotentil,salmiakpastil,lapidarstil,spidsbuestil	tekstil,projektil,reptil
3	ern	46	0.00011	8	38	koncern,tern,western,kemikoncern,spaghettiwestern,skaktern,klantern,salattern	jern,tern,håndjern,egern,strygejern,støbejern,agern,rivejern,knojern,brækjern,hakkejern,stemmejern,smedejern,skuffejern,krøllejern,lugejern,råkostjern,vaffeljern,glattejern,skaktern,plovjern,vinkeljern,spunsjern,rundjern,råjern,skrabejern,klantern,pladejern,huljern,rendejern,salattern,skavejern,høvlejern,båndjern,hyppejern,stangjern,virkejern,profiljern
3	bel	51	0.00011	38	13	bibel,tabel,jubel,stabel,rebel,rubel,fabel,zobel,hybel,sabel,konstabel,label,decibel,snabel,pøbel,knebel,vabel,variabel,snæbel,præambel,mirabel,krumsabel,parabel,brændestabel,tidstabel,drøbel,inkunabel,klokkestabel,dyrefabel,hyperbel,cymbel,flyverkonstabel,snøbel,polyglotbibel,invariabel,klokkeknebel,gangetabel,bræddestabel	møbel,kabel,kobbel,havemøbel,label,præambel,kurvemøbel,stilmøbel,lyslederkabel,polstermøbel,siddemøbel,skuffemøbel,telekabel
3	kib	34	0.00011	0	34		skib,flagskib,krigsskib,containerskib,fragtskib,rumskib,tankskib,sejlskib,vikingeskib,skoleskib,hangarskib,luftskib,passagerskib,inspektionsskib,dampskib,slagskib,moderskib,søsterskib,køleskib,kirkeskib,orlogsskib,fyrskib,miljøskib,sørøverskib,fiskeskib,langskib,motorskib,hotelskib,agterskib,smuglerskib,tværskib,roll-on-roll-off-skib,koffardiskib,fuldskib
3	tri	51	0.00010	51	0	industri,psykiatri,medicinalindustri,filmindustri,tobaksindustri,geometri,fiskeindustri,underholdningsindustri,symmetri,tekstilindustri,distriktspsykiatri,byggeindustri,jernindustri,asymmetri,storindustri,medicinindustri,sværindustri,geriatri,levnedsmiddelindustri,børnepsykiatri,teleindustri,pædiatri,kunstindustri,småindustri,kemiindustri,følgeindustri,egocentri,økonometri,køleindustri,nøgleindustri,psykometri,popindustri,trigonometri,biometri,bibliometri,forlystelsesindustri,telemetri,audiometri,fotometri,kolorimetri,kalometri,reguladetri,plangeometri,kronometri,idolatri,IT-industri,optometri,foniatri,isometri,stereometri,polycentri	
3	afi	64	0.00010	57	7	fotografi,biografi,scenografi,koreografi,geografi,selvbiografi,pornografi,litografi,demografi,monografi,mammografi,typografi,bibliografi,topografi,etnografi,ikonografi,kalligrafi,diskografi,serigrafi,ortografi,telegrafi,leksikografi,oceanografi,holografi,autobiografi,kulturgeografi,kartografi,krystallografi,kryptografi,stenografi,hagiografi,historiografi,elektrokardiografi,termografi,tomografi,elektroencefalografi,biogeografi,radiografi,xylografi,homografi,xerografi,hydrografi,ideografi,metallografi,reprografi,regionalgeografi,kardiografi,røntgenografi,zinkografi,selenografi,gaskromatografi,erhvervsgeografi,encefalografi,kinematografi,kemigrafi,palæografi,kromatografi	fotografi,litografi,mammografi,serigrafi,xylografi,pasfotografi,zinkografi
3	val	30	0.00010	28	2	festival,rival,hval,kval,musikfestival,kulturfestival,revival,oval,blåhval,pukkelhval,kaskelothval,finhval,grindehval,samvittighedskval,vågehval,narhval,liljekonval,tandhval,hvidhval,grønlandshval,sjælekval,bardehval,næbhval,rethval,dræberhval,spermacethval,konval,helvedeskval	interval,karneval
3	bil	34	0.00010	32	2	lastbil,mobil,personbil,elbil,varebil,politibil,firmabil,brandbil,familiebil,hybridbil,racerbil,automobil,veteranbil,rutebil,minibil,privatbil,mikrobil,delebil,brintbil,multibil,tankbil,mellemklassebil,radiobil,brugtbil,sæbekassebil,ulykkesbil,skrotbil,invalidebil,lånebil,fempersonersbil,nulemissionsbil,fossilbil	automobil,vegetabil
3	lov	36	0.00010	35	1	finanslov,grundlov,orlov,straffelov,barselsorlov,lukkelov,jantelov,naturlov,særlov,bistandslov,forældreorlov,plov,lejelov,færdselslov,tyngdelov,uddannelsesorlov,ferielov,junglelov,sneplov,købelov,arkivlov,jagtlov,klov,rammelov,fædreorlov,plejeorlov,landlov,forlov,jordlov,næringslov,hastelov,tallerkenplov,kommunallov,hyppeplov,reolplov	forlov
3	che	33	0.00010	32	1	branche,byggebranche,niche,revanche,planche,pastiche,kaleche,breche,broche,bruseniche,touche,moustache,gamache,gouache,apache,depeche,douche,galoche,quiche,brioche,drosche,poche,køkkenniche,retouche,ruche,dispache,creme fraiche,mikrofiche,ganache,ceviche,demarche,carte blanche	carte blanche
3	ids	30	0.00010	20	10	spids,aids,lakrids,fingerspids,spydspids,sydspids,knivspids,tåspids,nordspids,pilespids,vingespids,slids,tungespids,stanglakrids,stillids,saltlakrids,pibespids,sylespids,samojedespids,bændellakrids	lakrids,omrids,rids,stanglakrids,grundrids,saltlakrids,oprids,afrids,stirrids,bændellakrids
3	isk	65	0.00010	62	3	fisk,disk,pisk,harddisk,køledisk,guldfisk,hornfisk,bardisk,fladfisk,obelisk,hellefisk,menisk,klipfisk,basilisk,tørfisk,tunfisk,sværdfisk,plukfisk,rovfisk,klumpfisk,rødfisk,piratfisk,frysedisk,flyvefisk,ferskvandsfisk,skidtfisk,hvalfisk,sølvfisk,industrifisk,ridepisk,laserdisk,grønirisk,suppevisk,konsumfisk,asterisk,benfisk,odalisk,visk,blankfisk,bruskfisk,tudsefisk,sildefisk,agnfisk,tornirisk,stokfisk,tamarisk,neonfisk,kuffertfisk,sættefisk,koteletfisk,savfisk,skyttefisk,gydefisk,klatrefisk,sugefisk,slisk,rognfisk,dybvandsfisk,floppydisk,compactdisk,vragfisk,irisk	pisk,harnisk,baskisk
3	mel	48	0.00010	29	19	himmel,formel,kamel,strimmel,hjemmel,karamel,skammel,stjernehimmel,vrimmel,nattehimmel,lovhjemmel,lømmel,skimmel,sejrsskammel,lamel,tommel,tummel,hammel,fodskammel,flødekaramel,rejsehjemmel,rummel,blåskimmel,gråskimmel,stimmel,tronhimmel,bechamel,klæbestrimmel,kassestrimmel	hvedemel,skrammel,benmel,kartoffelmel,skrummel,rugmel,fiskemel,kokosmel,grahamsmel,krymmel,stenmel,mandelmel,programmel,vadmel,sigtemel,rismel,boghvedemel,grovmel,flormel
3	sen	37	0.00009	9	28	hilsen,rosen,opblussen,nazihilsen,gewesen,genopblussen,brasen,voksen,helsen	væsen,sundhedsvæsen,brandvæsen,skattevæsen,postvæsen,retsvæsen,skolevæsen,toldvæsen,rumvæsen,bankvæsen,uvæsen,telegrafvæsen,vejvæsen,arsen,løsen,pengevæsen,telefonvæsen,fornuftsvæsen,skovvæsen,parkvæsen,fyrvæsen,kastevæsen,asen,landvæsen,klikevæsen,pensionsvæsen,klitvæsen,åndevæsen
3	tær	20	0.00009	19	1	generalsekretær,sekretær,stær,lægesekretær,redaktionssekretær,direktionssekretær,ministersekretær,ekspeditionssekretær,skolesekretær,proprietær,advokatsekretær,privatsekretær,chefsekretær,kabinetssekretær,beostær,vandstær,protokolsekretær,justitssekretær,parlamentær	militær
3	men	37	0.00009	20	17	eksamen,studentereksamen,volumen,realeksamen,afgangseksamen,lærereksamen,spidskommen,gruppeeksamen,komsammen,slagvolumen,reeksamen,hymen,sygeeksamen,bitumen,adgangseksamen,stammen,kommen,dekalumen,tentamen,lumen	fænomen,volumen,komsammen,slagvolumen,pronomen,omen,rodsammen,bitumen,skrabsammen,nomen,ledsagefænomen,tiltalepronomen,possessivpronomen,spørgepronomen,refleksivpronomen,relativpronomen,demonstrativpronomen
3	gte	22	0.00009	19	3	sigte,lygte,lægte,forlygte,lommelygte,hægte,baglygte,tågelygte,hornlygte,billygte,stoplygte,stavlygte,dynamolygte,flagermuslygte,blinklygte,baklygte,signallygte,purésigte,karbidlygte	rygte,sigte,kikkertsigte
3	ffe	20	0.00009	19	1	kaffe,skuffe,morgenkaffe,eftermiddagskaffe,aftenkaffe,formiddagskaffe,muffe,luffe,pulverkaffe,kommodeskuffe,stempelkaffe,samlemuffe,kolbekaffe,neskaffe,tordenkaffe,råkaffe,gravkaffe,javakaffe,iskaffe	straffe
3	dør	29	0.00009	29	0	ambassadør,leverandør,underleverandør,hoveddør,bagdør,kommandør,skydedør,fordør,svingdør,assurandør,storleverandør,gadedør,hofleverandør,yderdør,stalddør,branddør,dobbeltdør,fløjdør,entrédør,foldedør,odør,halvdør,procedør,rekommandør,hækdør,blænddør,tapetdør,løndør,blinddør	
3	fer	39	0.00009	24	15	transfer,træffer,surfer,fuldtræffer,buffer,schæfer,skifer,golfer,subwoofer,blaffer,windsurfer,strejfer,kitesurfer,kamfer,skaffer,sniffer,ruffer,omstrejfer,bluffer,anverfer,kaffer,glimmerskifer,kalorifer,akvifer	offer,ciffer,dødsoffer,voldsoffer,mobbeoffer,kamfer,trafikoffer,torturoffer,sonoffer,brændoffer,slagtoffer,chiffer,takoffer,drikoffer,skyldoffer
3	per	100	0.00009	99	1	stopper,hjælper,hjemmehjælper,keeper,dæmper,frihedskæmper,skipper,medhjælper,pædagogmedhjælper,autocamper,forkæmper,sygehjælper,sorteper,afhopper,plæneklipper,kidnapper,stripper,fødselshjælper,frontkæmper,støddæmper,slapper,pamper,developer,menneskerettighedsforkæmper,studentermedhjælper,fiskeskipper,hiphopper,klipper,damper,flipper,jumper,rygklapper,vesper,sweeper,lyddæmper,skihopper,nordkaper,hjuldamper,bagstopper,gatekeeper,filmklipper,kaper,chopper,klapper,tipper,bipper,lysdæmper,klimaforkæmper,medkæmper,dumper,vinkyper,køkkenmedhjælper,førstehjælper,tølper,femkæmper,fluesnapper,souper,dørstopper,forsigtigper,samfundshjælper,tikæmper,kystskipper,kuponklipper,sandpumper,bogdropper,stamper,sætteskipper,rotorklipper,forstopper,zapper,negleklipper,stymper,svupper,papirklipper,egotripper,akuthjælper,støjdæmper,øltapper,gottorper,tapper,græsklipper,flueknepper,gartnermedhjælper,kyper,frøsnapper,vigtigper,knabstrupper,skubopper,standupper,terper,social- og sundhedshjælper,indhopper,desktopper,vintapper,opstopper,handicapper,namedropper,tre i en-negleklipper,trampdamper	kiper
3	pir	46	0.00009	2	44	tapir,skaberaktapir	papir,værdipapir,bagepapir,spir,toiletpapir,avispapir,brevpapir,arbejdspapir,sandpapir,sølvpapir,identitetspapir,gavepapir,talepapir,genbrugspapir,fluepapir,silkepapir,rispapir,madpapir,slikpapir,pergamentpapir,ispapir,trækpapir,glanspapir,mellemlægspapir,karbonpapir,returpapir,kopipapir,smørrebrødspapir,bøttepapir,forståelsespapir,karduspapir,crepepapir,filtrerpapir,skrivepapir,kalkerpapir,hyldepapir,klisterpapir,klatpapir,kopierpapir,konceptpapir,indiapapir,forsatspapir,WC-papir,trykpapir
3	rme	25	0.00009	20	5	varme,charme,fjernvarme,harme,sommervarme,gulvvarme,solvarme,jordvarme,centralvarme,sædevarme,spildvarme,hjertevarme,bærme,kropsvarme,terme,strålevarme,herme,lummervarme,smeltevarme,kulkraftvarme	ærme,skjorteærme,pufærme,flagermusærme,skinkeærme
3	ræt	43	0.00009	5	38	idræt,eliteidræt,breddeidræt,handicapidræt,fiskedræt	portræt,bræt,åndedræt,selvportræt,tegnebræt,springbræt,opdræt,gulvbræt,instrumentbræt,trinbræt,skærebræt,foderbræt,skakbræt,surfbræt,regnebræt,vaskebræt,strygebræt,spækbræt,hakkebræt,toiletbræt,gribebræt,vippebræt,sternbræt,skærmbræt,profilbræt,forskallingsbræt,smørebræt,bundbræt,pudsebræt,gangbræt,kniplebræt,fiskedræt,himmelspræt,sejlbræt,ærmebræt,forskærerbræt,rivebræt,slibebræt
3	øve	42	0.00009	42	0	prøve,løve,blodprøve,smagsprøve,generalprøve,afgangsprøve,stikprøve,styrkeprøve,køreprøve,svendeprøve,søløve,lakmusprøve,læseprøve,lydprøve,vareprøve,strandløve,terminsprøve,stopprøve,årsprøve,jagtprøve,ildprøve,spiritusprøve,farveprøve,adgangsprøve,kraftprøve,forprøve,synsprøve,intelligensprøve,høreprøve,duelighedsprøve,materialeprøve,balløve,omprøve,penneprøve,svømmeprøve,myreløve,skolemodenhedsprøve,kontraprøve,lappeprøve,rorschachprøve,indstillingsprøve,frisvømmerprøve	
3	yse	23	0.00009	23	0	analyse,psykoanalyse,markedsanalyse,dyse,dialyse,kyse,hypofyse,tekstanalyse,billedanalyse,gemyse,elektrolyse,behovsanalyse,konsekvensanalyse,katalyse,pollenanalyse,paralyse,systemanalyse,hydrolyse,pyrolyse,mediaanalyse,fotolyse,titreranalyse,cost-benefit-analyse	
3	ral	39	0.00009	35	4	general,moral,central,spiral,katedral,dobbeltmoral,alarmcentral,admiral,koral,brigadegeneral,gral,kontreadmiral,datacentral,kommandocentral,korporal,viceadmiral,seksualmoral,voldsspiral,umoral,mistral,oral,skrivebordsgeneral,amoral,værdipapircentral,hjælpemiddelcentral,orgelkoral,nyttemoral,kobberspiral,budcentral,kræmmermoral,ædelkoral,ekstemporal,guttural,lateral,droit moral	mineral,pral,integral,foderal
3	lot	30	0.00009	21	9	pilot,fartpilot,merlot,kaospilot,kalot,jagerpilot,automatpilot,autopilot,helikopterpilot,kaskelot,andenpilot,testpilot,chefpilot,kamikazepilot,jetpilot,zelot,papillot,ozelot,rumpilot,polyglot,sansculot	slot,plot,komplot,vinslot,sandslot,renæssanceslot,torneroseslot,drømmeslot,blot
3	yre	55	0.00009	43	12	syre,nyre,hyre,fedtsyre,myre,aminosyre,garvesyre,kulsyre,lyre,mælkesyre,saltsyre,svovlsyre,mavesyre,eddikesyre,acetylsalicylsyre,skovsyre,citronsyre,transfedtsyre,salpetersyre,binyre,oxalsyre,blåsyre,urinsyre,tissemyre,nukleinsyre,myresyre,salicylsyre,smørsyre,fosforsyre,skovmyre,hærmyre,borsyre,karbolsyre,kiselsyre,linolsyre,benzoesyre,askorbinsyre,humussyre,druesyre,skrumpenyre,vandrenyre,karboxylsyre,valerianesyre	styre,selvstyre,folkestyre,uhyre,bystyre,hjemmestyre,landsstyre,præstestyre,kolonistyre,kommunestyre,centralstyre,interimsstyre
3	ase	31	0.00008	30	1	base,fase,database,vase,oase,slutfase,frase,ekstase,klase,parafrase,striptease,metastase,startfase,release,galease,case,kvase,drueklase,blase,gase,månefase,lipase,stase,vindrueklase,analfase,alabastvase,hypostase,perifrase,emfase,genitalfase	steeplechase
3	org	23	0.00008	23	0	sorg,omsorg,borg,kriminalforsorg,højborg,kærestesorg,ældreomsorg,rockerborg,hoppeborg,sjælesorg,forsorg,landesorg,hjertesorg,børneforsorg,cyborg,socialforsorg,kærlighedssorg,særforsorg,vognborg,ungdomsforsorg,hofsorg,faneborg,dorg	
3	mor	27	0.00008	25	2	humor,mormor,bedstemor,farmor,husmor,svigermor,tumor,oldemor,stedmor,dagplejemor,alenemor,galgenhumor,plejemor,madmor,gudmor,papmor,tipoldemor,hønemor,singlemor,bonusmor,hjernetumor,ravnemor,medmor,solomor,plasticmor	marmor,perlemor
3	ule	29	0.00008	29	0	smule,hule,bule,mule,kalkule,armhule,mundhule,sule,hjertekule,bughule,kulmule,øjenhule,klippehule,vestibule,spillebule,kilojoule,joule,bihule,kule,boule,røverkule,brysthule,løvekule,roekule,kæbehule,pandehule,kalkkule,opiumhule,fedtmule	
3	rin	57	0.00008	21	36	urin,doktrin,rosmarin,mandarin,farin,terrin,amorin,latrin,stearin,tamburin,klorin,glycerin,florin,nektarin,nitroglycerin,suppeterrin,mazarin,ultramarin,akvamarin,citrin,dekstrin	grin,trin,optrin,klassetrin,fejltrin,fortrin,mandarin,dansetrin,trappetrin,dørtrin,skrin,farin,mellemtrin,udviklingstrin,løntrin,alderstrin,smykkeskrin,latrin,stearin,dollargrin,fodtrin,klorin,grundtrin,ultramarin,relikvieskrin,helgenskrin,sakkarin,syskrin,rakettrin,chagrin,stødtrin,halvtonetrin,studietrin,heltonetrin,tonetrin,juvelskrin
3	ude	48	0.00008	48	0	rude,attitude,pude,knude,snude,skude,forrude,staude,siderude,hårdknude,bagrude,drude,sovepude,hovedpude,termorude,etude,stødpude,kræftknude,åreknude,lymfeknude,slipseknude,sofapude,skulderpude,skosnude,trædepude,varmepude,hårknude,brændeknude,selepude,hinkerude,marokkopude,forsatsrude,amplitude,frugtknude,pæreskude,platitude,trækrude,frostknude,dobbeltknude,stempelpude,isoleringsrude,kællingeknude,dobbeltrude,reineclaude,ratpude,blåpude,dugrude,råbåndsknude	
3	yde	20	0.00008	20	0	gryde,lyde,jyde,nordjyde,sønderjyde,vestjyde,midtjyde,gyde,blindgyde,østjyde,kødgryde,kronjyde,stegegryde,klyde,frituregryde,skarntyde,fonduegryde,gifttyde,jættegryde,nørrejyde	
3	rue	20	0.00008	20	0	frue,drue,skrue,havfrue,præsidentfrue,vindrue,skatteskrue,tommelskrue,morgenfrue,enkefrue,oldfrue,pastaskrue,stilleskrue,bundskrue,strammeskrue,vingeskrue,mikrometerskrue,spændeskrue,tapskrue,klemskrue	
3	bog	77	0.00008	77	0	dagbog,ordbog,kogebog,tegnebog,håndbog,børnebog,billedbog,lærebog,drejebog,årbog,salmebog,debatbog,fagbog,hvidbog,lydbog,bankbog,telefonbog,ordrebog,logbog,karakterbog,sangbog,retskrivningsordbog,samtalebog,rejsebog,grundbog,gæstebog,opslagsbog,portrætbog,ungdomsbog,instruktionsbog,scrapbog,kirkebog,lommebog,poesibog,retsbog,tingbog,fremmedordbog,læsebog,adressebog,skolebog,malebog,billigbog,pixibog,stambog,grønspættebog,dombog,kortbog,dødebog,voksenbog,regnebog,jordebog,alterbog,pegebog,koralbog,kassebog,slægtsbog,soldaterbog,netordbog,ministerialbog,hovedbog,pocketbog,tidebog,letlæsningsbog,læseletbog,visebog,kladdebog,onlineordbog,stilebog,pop op-bog,tosprogsordbog,e-bog,evangeliebog,tapetbog,Mosebog,etsprogsordbog,noterebog,øvebog	
3	ran	31	0.00007	24	7	veteran,gran,sopran,koran,kran,uran,tyran,mezzosopran,membran,safran,katamaran,tran,rødgran,nordmannsgran,varan,ædelgran,mobilkran,levertran,komodovaran,hustyran,douglasgran,flydekran,nobilisgran,løbekran	gran,uran,safran,tran,levertran,filigran,støvgran
3	tum	26	0.00007	4	22	præteritum,perfektum,imperfektum,pluskvamperfektum	faktum,punktum,momentum,ultimatum,mistillidsvotum,depositum,kvantum,diktum,votum,faktotum,stratum,præteritum,perfektum,postscriptum,imperfektum,kompositum,pluskvamperfektum,forkortelsespunktum,desideratum,slutpunktum,petitum,erratum
3	tus	25	0.00007	24	1	status,spiritus,gestus,emeritus,særstatus,stjernestatus,kaktus,tinnitus,kultstatus,habitus,lavstatus,observatørstatus,raptus,salmiakspiritus,eukalyptus,højstatus,lotus,akantus,novemberkaktus,julekaktus,figenkaktus,rekvisitus,kultus,sprittus	coitus
3	due	27	0.00007	11	16	brevdue,turteldue,skovdue,lerdue,fredsdue,lokkedue,fondue,ringdue,kakadue,tyrkerdue,kropdue	vindue,ovenlysvindue,butiksvindue,tagvindue,forsatsvindue,dannebrogsvindue,palævindue,kvistvindue,ateliervindue,karnapvindue,vippevindue,skydevindue,pop op-vindue,tofagsvindue,trefagsvindue,rosevindue
3	eds	24	0.00007	24	0	kreds,omgangskreds,inderkreds,vennekreds,valgkreds,storkreds,kundekreds,rundkreds,studiekreds,omkreds,retskreds,læsekreds,enkeltmandskreds,læserkreds,dyrekreds,bibelkreds,vendekreds,skyldkreds,sagnkreds,strømkreds,synskreds,polarkreds,breddekreds,længdekreds	
3	oks	31	0.00007	25	6	voks,boks,stemmeboks,tænkeboks,telefonboks,postboks,faktaboks,bankboks,jukeboks,straffeboks,køleboks,modellervoks,bivoks,døgnboks,fryseboks,tagboks,rytmeboks,bagageboks,frostboks,ørevoks,dialogboks,beautyboks,koks,smørboks,floks	voks,paradoks,modellervoks,bivoks,ørevoks,koks
3	mat	35	0.00007	21	14	diplomat,tomat,automat,pengeautomat,spilleautomat,skakmat,hæveautomat,datamat,primat,billetautomat,cherrytomat,fermat,kasemat,flaskeautomat,bøftomat,vekselautomat,seddelautomat,koksmat,drikkeautomat,kolddriksautomat,varmdriksautomat	format,estimat,primat,bredformat,smat,tabloidformat,cyklamat,A3-format,MP3-format,kvartformat,A5-format,oktavformat,A4-format,sublimat
3	alt	35	0.00007	21	14	asfalt,læreanstalt,galt,anstalt,pjalt,badeanstalt,gestalt,spalt,galeanstalt,basalt,forbrændingsanstalt,destruktionsanstalt,straffeanstalt,søbadeanstalt,malt,gehalt,gevalt,opstalt,kontraalt,slaveanstalt,reproduktionsanstalt	salt,havsalt,vejsalt,næringssalt,verdensalt,hjortetaksalt,flagesalt,køkkensalt,malt,sellerisalt,middelhavssalt,kogsalt,filtersalt,syresalt
3	ier	79	0.00007	75	4	spanier,australier,belgier,canadier,somalier,konferencier,bosnier,armenier,metier,terrier,georgier,frier,pier,tier,sommelier,saudier,algerier,nier,befrier,etiopier,elegantier,kostumier,arier,portier,forbier,bankier,catalonier,malaysier,gnier,lancier,californier,natportier,bulkcarrier,croupier,foxterrier,biedermeier,kulsvier,pitbullterrier,gambier,financier,malier,tanzanier,polynesier,zambier,grenadier,patricier,andalusier,kaukasier,rentier,babylonier,nubier,mauretanier,malawier,namibier,denier,burundier,yorkshireterrier,airedaleterrier,olympier,abessinier,melanesier,eurasier,particulier,caribier,kiribatier,skotskterrier,mauritier,barbadier,mikronesier,bruneier,helvetier,mesopotamier,sardinier,oceanier,djiboutier	atelier,collier,espalier,dossier
3	mpe	55	0.00007	55	0	lampe,ulempe,kæmpe,pumpe,rampe,strømpe,krampe,varmepumpe,advarselslampe,rødstrømpe,rumpe,trampe,nylonstrømpe,tumpe,pandelampe,glødelampe,bordlampe,vandpumpe,standerlampe,petroleumslampe,netstrømpe,læselampe,støttestrømpe,skypumpe,stivkrampe,halogenlampe,cykelpumpe,knæstrømpe,arkitektlampe,tranlampe,kontrollampe,klumpedumpe,anderumpe,klampe,gimpe,skrivekrampe,læsserampe,blæselampe,vågelampe,sportsstrømpe,blåstrømpe,loftlampe,barnerumpe,glimlampe,kulbuelampe,buelampe,gyllepumpe,trykpumpe,sugepumpe,stålampe,himpegimpe,kiplampe,alabastlampe,klemlampe,koldtvandspumpe	
3	tag	39	0.00007	1	38	klittag	tiltag,håndtag,overtag,livtag,indtag,snuptag,optag,kvælertag,stråtag,favntag,halvtag,tegltag,soltag,hustag,hashtag,udtag,luftindtag,svømmetag,stag,skifertag,åretag,skydetag,saddeltag,strømudtag,mansardtag,meroptag,aftag,lampeudtag,brydetag,bagstag,skråtag,spåntag,nappetag,builtuptag,vaterstag,varmeudtag,gavltag,shedtag
3	las	37	0.00006	3	34	husblas,vandglas,dowlas	glas,atlas,vinglas,reagensglas,brilleglas,timeglas,forstørrelsesglas,plexiglas,ølglas,vandglas,krystalglas,drikkeglas,snapseglas,sylteglas,rødvinsglas,spejlglas,cognacglas,kalas,bægerglas,henkogningsglas,patentglas,råglas,brændeglas,marieglas,objektglas,cylinderglas,toddyglas,måleglas,flintglas,monierglas,dowlas,flerstyrkeglas,rømerglas,planglas
3	oni	40	0.00006	37	3	symfoni,koloni,ironi,harmoni,ceremoni,telefoni,selvironi,mobiltelefoni,simoni,monotoni,dæmoni,kronkoloni,feriekoloni,disharmoni,kakofoni,havekoloni,fastnettelefoni,radiofoni,diakoni,makaroni,polyfoni,pneumoni,svagbørnskoloni,peperoni,cannelloni,homofoni,kosmogoni,synkroni,agoni,eudaimoni,dodekafoni,atoni,stereofoni,eutoni,IP-telefoni,kvadrofoni,diakroni	hegemoni,deponi,baroni
3	nom	23	0.00006	20	3	økonom,cheføkonom,astronom,civiløkonom,agronom,merkonom,gastronom,nationaløkonom,farmakonom,hortonom,gnom,metronom,kommunom,agrarøkonom,erhvervsøkonom,rundtenom,grafonom,datanom,teknonom,ergonom	genom,karcinom,melanom
3	ugl	49	0.00006	49	0	fugl,sommerfugl,rovfugl,trækfugl,sangfugl,påfugl,guldfugl,kanariefugl,ynglefugl,vadefugl,edderfugl,spillefugl,urfugl,spøgefugl,dagsommerfugl,isfugl,ulykkesfugl,andefugl,svømmefugl,kragefugl,kålsommerfugl,pipfugl,spurvefugl,hønsefugl,standfugl,vandrefugl,hærfugl,vildfugl,citronsommerfugl,fregatfugl,silkesommerfugl,spottefugl,gejrfugl,alkefugl,næsehornsfugl,bynkefugl,kramsfugl,stormfugl,galgenfugl,væverfugl,strudsefugl,brokfugl,skrigefugl,storkefugl,pomeransfugl,sekretærfugl,harlekinsommerfugl,strejffugl,risfugl	
3	arm	37	0.00006	37	0	alarm,larm,tarm,farm,vindueskarm,barm,overarm,underarm,minkfarm,tyverialarm,røgalarm,brandalarm,karm,tyktarm,endetarm,dørkarm,gendarm,blindtarm,fangarm,tyndtarm,luftalarm,charm,kyllingefarm,babyalarm,tolvfingertarm,katastrofealarm,svingarm,hjortefarm,musearm,ålefarm,hønsefarm,vippearm,hønsetarm,kranarm,harm,skødbarm,friarm	
3	vin	43	0.00006	26	17	rødvin,hvidvin,portvin,pingvin,brændevin,dessertvin,rosévin,kelvin,hedvin,bordvin,kirsebærvin,papvin,risvin,landvin,frugtvin,kejserpingvin,kongepingvin,bællevin,vildvin,rhinskvin,moselvin,olivin,rådhusvin,gåsevin,russervin,anjouvin	svin,marsvin,vildsvin,slagtesvin,pindsvin,hvin,søpindsvin,skovsvin,vortesvin,tamsvin,møgsvin,hulepindsvin,vejsvin,fedesvin,kølsvin,slagterisvin,navlesvin
3	ers	20	0.00006	12	8	østers,kontrovers,revers,asters,kommers,kapers,vinterasters,avers,travers,kippers,slippers,smutters	univers,vers,bryggers,salmevers,revers,vrøvlevers,blankvers,knittelvers
3	sin	23	0.00006	7	16	appelsin,rosin,dessin,bekkasin,blodappelsin,mokkasin,dobbeltbekkasin	magasin,bassin,stormagasin,dusin,havnebassin,svømmebassin,modemagasin,dessin,toksin,ligkistemagasin,soppebassin,pepsin,aflatoksin,pluviusin,antitoksin,karmoisin
3	ærm	21	0.00006	21	0	skærm,storskærm,faldskærm,sværm,lampeskærm,forskærm,radarskærm,bagskærm,solskærm,læskærm,bisværm,billedskærm,vindskærm,dataskærm,berøringsskærm,pauseskærm,kædeskærm,klaseskærm,LCD-skærm,tolvtommerskærm,stænkskærm	
3	jul	22	0.00006	0	22		skjul,hjul,baghjul,forhjul,lykkehjul,tandhjul,skalkeskjul,løbehjul,frihjul,pariserhjul,reservehjul,møllehjul,svinghjul,gummihjul,næsehjul,skovlhjul,drivhjul,kronhjul,snekkehjul,elløbehjul,planethjul,underfaldshjul
3	lin	38	0.00006	22	16	disciplin,violin,insulin,adrenalin,penicillin,trampolin,gobelin,selvdisciplin,mandolin,andenviolin,førsteviolin,kadaverdisciplin,hermelin,formalin,kaolin,poplin,lanolin,turmalin,anilin,sekundoviolin,primoviolin,ravelin	insulin,adrenalin,penicillin,gobelin,velin,formalin,kaolin,poplin,meskalin,lanolin,vanillin,musselin,anilin,postelin,ptyalin,tuberkulin
3	top	30	0.00006	18	12	partitop,bjergtop,dansktop,trætop,laptop,isotop,snurretop,biotop,bølgetop,desktop,krøltop,hardtop,hårtop,bikinitop,skumtop,soltop,blåtop,palmtop	stop,skattestop,hjertestop,rygestop,ansættelsesstop,byggestop,motorstop,lønstop,indvandrerstop,spilstop,prisstop,indvandringsstop
3	rød	58	0.00005	13	45	grød,risengrød,havregrød,rødgrød,øllebrød,vandgrød,rabarbergrød,boghvedegrød,frugtgrød,byggrød,sveskegrød,sødgrød,vandrisengrød	brød,rugbrød,smørrebrød,levebrød,franskbrød,wienerbrød,snobrød,knækbrød,hvedebrød,pitabrød,toastbrød,fladbrød,grovbrød,sandwichbrød,landbrød,marcipanbrød,pølsebrød,fuldkornsbrød,surbrød,kuvertbrød,studenterbrød,sigtebrød,nådsensbrød,formbrød,landgangsbrød,kvædebrød,finskbrød,trekornsbrød,kernerugbrød,grahamsbrød,klidbrød,rosinbrød,ciabattabrød,skuebrød,johannesbrød,rosenbrød,nanbrød,walesbrød,sukkerbrød,birkesbrød,focacciabrød,filonebrød,sesambrød,bibrød,glutenbrød
3	mbe	30	0.00005	30	0	bombe,atombombe,selvmordsbombe,bilbombe,vejsidebombe,klyngebombe,brandbombe,brevbombe,katakombe,krysantemumbombe,brintbombe,sexbombe,rørbombe,plombe,bordbombe,røgbombe,gambe,stinkbombe,dybvandsbombe,neutronbombe,jambe,rombe,jumbe,telefonbombe,guldplombe,korjambe,b-bombe,hekatombe,a-bombe,dityrambe	
3	lip	24	0.00005	5	19	slip,flip,øreflip,knækflip,kinaflip	udslip,klip,slip,videoklip,flip,filmklip,udklip,papirklip,juleklip,fraklip,lydklip,grineflip,sammenklip,herreklip,kludeklip,dækslip,dameklip,børneklip,farveklip
3	kal	22	0.00005	21	1	skal,pokal,vokal,nøddeskal,hofmarskal,muslingeskal,vandrepokal,appelsinskal,sjakal,marskal,knæskal,feltmarskal,æggeskal,hovedskal,hjerneskal,vertikal,pandeskal,havkal,bananskal,ibskal,kitinskal	radikal
3	vel	21	0.00005	18	3	djævel,juvel,kronjuvel,kørvel,hvirvel,ryghvirvel,fartdjævel,trommehvirvel,gyvel,halshvirvel,strømhvirvel,hundjævel,dyvel,karavel,svirvel,knavel,kravel,graphic novel	farvel,almenvel,levvel
3	rit	26	0.00005	21	5	favorit,storfavorit,merit,sprit,meteorit,kolorit,esprit,samarit,lokalkolorit,håndsprit,finsprit,træsprit,pomfrit,margerit,kogesprit,dendrit,ferrit,vinsprit,dolerit,fluorit,tørsprit	trit,antrit,nitrit,sanskrit,natriumnitrit
3	løn	26	0.00005	26	0	efterløn,mindsteløn,månedsløn,timeløn,årsløn,ligeløn,realløn,grundløn,resultatløn,indslusningsløn,ugeløn,dagløn,slutløn,findeløn,uligeløn,sulteløn,lokalløn,livsløn,minimalløn,topløn,skalaløn,bjergeløn,lavtløn,minimumløn,projektløn,tidløn	
3	sus	20	0.00005	10	10	luksus,konsensus,passus,pegasus,lapsus,census,kasus,krøsus,usus,neksus	kursus,vingesus,grundkursus,studenterkursus,begynderkursus,brevkursus,internatkursus,korrespondancekursus,båndsus,brushupkursus
3	ble	29	0.00005	11	18	boble,double,boligboble,sæbeboble,taleboble,faible,pasodoble,tekstboble,diner transportable,enfant terrible,mixed double	æble,ensemble,granatæble,paradisæble,øjeæble,madæble,spiseæble,adamsæble,pigæble,vinteræble,galæble,gemmeæble,skovfogedæble,golden delicious-æble,ingridmarieæble,flaskeæble,guldborgæble,enfant terrible
3	bær	61	0.00005	27	34	jordbær,kirsebær,laurbær,hindbær,brombær,solbær,blåbær,enebær,stikkelsbær,tranebær,tyttebær,morbær,multebær,snebær,galnebær,boysenbær,jødekirsebær,galdebær,korbær,kermesbær,etbær,krægebær,bjørnebær,melbær,kornelbær,krækkebær,fruebær	jordbær,kirsebær,laurbær,hindbær,brombær,solbær,blåbær,enebær,stikkelsbær,tranebær,rønnebær,tyttebær,hyldebær,skovjordbær,skovbær,morbær,multebær,snebær,ananaskirsebær,gojibær,boysenbær,jødekirsebær,slåenbær,dessertkirsebær,kermesbær,korbær,bjørnebær,bøllebær,acaibær,melbær,krægebær,fruebær,krækkebær,kornelbær
3	ack	23	0.00005	15	8	back,feedback,snack,hatchback,paperback,quarterback,wingback,hardback,blackjack,runningback,halfback,slingback,hackysack,crack,sixpack	comeback,feedback,soundtrack,flashback,playback,rack,dirttrack,crack
3	ton	49	0.00005	39	10	badminton,beton,maraton,karton,baryton,føljeton,halvmaraton,proton,mælkekarton,kanton,charleston,foton,singleton,jeton,ponton,basbaryton,gasbeton,crouton,gigaton,megaton,jernbeton,doubleton,kiloton,pyton,futon,teuton,bruttoregisterton,peloton,spændbeton,letbeton,feston,fronton,registerton,triton,keton,boston,piston,tripleton,newton	maraton,karton,halvmaraton,plankton,krypton,gigaton,megaton,kiloton,bruttoregisterton,registerton
3	als	25	0.00005	25	0	hals,vals,flaskehals,fals,vovehals,smalhals,løgnhals,livmoderhals,wienervals,rødhals,pralhals,skrighals,kælderhals,tandhals,svanehals,skabhals,slughals,lårhals,skrålhals,blærehals,trippevals,violinhals,vendehals,krumhals,tyrolervals	
3	øje	47	0.00005	34	13	trøje,førertrøje,løje,papegøje,hættetrøje,hængekøje,spændetrøje,bøje,køje,undertrøje,møje,striktrøje,spillertrøje,søpapegøje,uldtrøje,misnøje,overkøje,underkøje,dagpåfugleøje,okseøje,dværgpapegøje,guldøje,soløje,stortrøje,meldrøje,blåøje,påfugleøje,niøje,randøje,jockeytrøje,føje,varpebøje,færøtrøje,negenøje	nåleøje,koøje,glasøje,boldøje,misnøje,sæbeøje,katteøje,fiskeøje,tigerøje,argusøje,røntgenøje,isseøje,døje
3	fel	33	0.00005	30	3	kartoffel,gaffel,riffel,trøffel,vaffel,karaffel,bøffel,tøffel,isvaffel,falafel,røffel,salonriffel,aspargeskartoffel,bagekartoffel,vandbøffel,griffel,læggekartoffel,forgaffel,stemmegaffel,pillekartoffel,stegegaffel,brasekartoffel,hasselbackkartoffel,giffel,åregaffel,fiskegaffel,pålægsgaffel,pølsegiffel,bintjekartoffel,bådkartoffel	taffel,nytårstaffel,rijsttafel
3	cer	21	0.00005	21	0	officer,producer,cancer,spencer,racer,freelancer,søofficer,reserveofficer,forbindelsesofficer,filmproducer,skibsofficer,flådeofficer,transducer,pacer,sequencer,linjeofficer,breakdancer,influencer,alsacer,gardeofficer,juicer	
3	rør	37	0.00005	0	37		oprør,talerør,ungdomsoprør,vandrør,sugerør,lysstofrør,spiserør,sukkerrør,spanskrør,nedløbsrør,udstødningsrør,luftrør,drænrør,urinrør,tændrør,stålrør,neonrør,tagrør,billedrør,peddigrør,gasrør,hørerør,pusterør,afløbsrør,kakkelovnsrør,lysrør,elektronrør,strålerør,gløderør,sindsoprør,hårrør,ravrør,T-rør,knærør,U-rør,teleskoprør,gærrør
3	reg	25	0.00004	25	0	streg,målstreg,genistreg,drengestreg,lærestreg,svinestreg,narrestreg,kridtstreg,bindestreg,tuareg,tankestreg,tappenstreg,skråstreg,skarnsstreg,rævestreg,tossestreg,skurkestreg,abekattestreg,talestreg,slyngelstreg,skælmsstreg,replikstreg,nedstreg,skillestreg,opstreg	
3	lon	50	0.00004	39	11	ballon,salon,pavillon,skabelon,bouillon,klon,frisørsalon,melon,cyklon,triatlon,hønsebouillon,nylon,pylon,prøveballon,vandmelon,luftballon,gallon,halon,tesalon,teflon,vallon,honningmelon,fiskebouillon,talon,vandballon,spærreballon,duatlon,skrigeballon,postillon,netmelon,galon,muflon,dralon,kantalupmelon,orlon,kotillon,stræknylon,biatlon,crepenylon	nylon,halon,teflon,semikolon,kolon,epsilon,ypsilon,dralon,crepenylon,orlon,stræknylon
3	ket	32	0.00004	29	3	raket,kasket,buket,etiket,blanket,cricket,kroket,basket,rumraket,briket,brudebuket,tretrinsraket,asket,banket,kateket,jaket,bårebuket,musket,måneraket,totrinsraket,paket,giroblanket,bremseraket,flertrinsraket,murerkasket,bæreraket,festblanket,lumberjacket,luft til jord-raket	parket,kroket,busket
3	kop	35	0.00004	12	23	biskop,edderkop,ærkebiskop,kaffekop,tekop,sugekop,underkop,fugleedderkop,korsedderkop,smørekop,tudekop,dodenkop	mikroskop,teleskop,horoskop,kalejdoskop,stetoskop,periskop,endoskop,oscilloskop,gyroskop,gastroskop,stereoskop,spektroskop,stroboskop,bronkoskop,otoskop,laryngoskop,takistoskop,embryoskop,episkop,elektroskop,galvanoskop,epidiaskop,rektoskop
3	rus	35	0.00004	19	16	virus,citrus,lazarus,blodrus,papyrus,sejrsrus,glædesrus,computervirus,tyrannosaurus,cerberus,lykkerus,zikavirus,uterus,retrovirus,latyrus,coronavirus,brontosaurus,tesaurus,PC-virus	virus,grus,krus,brus,computervirus,perlegrus,stabilgrus,zikavirus,retrovirus,tekrus,tandkrus,coronavirus,nyregrus,numerus,tinkrus,PC-virus
3	dyr	60	0.00004	0	60		kæledyr,husdyr,rovdyr,pattedyr,skaldyr,rådyr,skadedyr,rensdyr,krybdyr,forsøgsdyr,udyr,dådyr,tøjdyr,fabeldyr,byttedyr,krondyr,krebsdyr,trækdyr,vilddyr,muldyr,flokdyr,bløddyr,hvirveldyr,handyr,skaffedyr,dovendyr,slagtedyr,nyttedyr,krammedyr,bunddyr,bæltedyr,næbdyr,borgerdyr,hundyr,pungdyr,stinkdyr,desmerdyr,elsdyr,leddyr,tamdyr,hovdyr,værtsdyr,ungdyr,murmeldyr,mosdyr,kloakdyr,totemdyr,klovdyr,polypdyr,skældyr,koraldyr,klappedyr,tøffeldyr,snyltedyr,infusionsdyr,kolonidyr,gribedyr,slimdyr,pibedyr,trompetdyr
3	nat	34	0.00004	13	21	midnat,granat,spinat,håndgranat,nytårsnat,koordinat,magnat,fnat,ostinat,mortérgranat,kognat,ordinat,agnat	senat,pensionat,koordinat,internat,laminat,ornat,championat,fnat,sultanat,karbonat,bikarbonat,ostinat,dekanat,patronat,natriumbikarbonat,mæcenat,diakonat,rabbinat,fyrlaminat,natriumkarbonat,tribunat
3	niv	30	0.00004	30	0	kniv,sparekniv,køkkenkniv,hobbykniv,brødkniv,foldekniv,lommekniv,kokkekniv,springkniv,ragekniv,schweizerkniv,paletkniv,urtekniv,giftekniv,barberkniv,slagterkniv,fiskekniv,filetkniv,papirkniv,skrællekniv,frugtkniv,opsprættekniv,chartreusekniv,slirekniv,trancherkniv,flænsekniv,opskærekniv,tollekniv,skavekniv,raderkniv	
3	orn	41	0.00004	10	31	torn,ahorn,ligtorn,havtorn,dorn,kristtorn,ildtorn,bukketorn,grentorn,vrietorn	korn,horn,næsehorn,overflødighedshorn,guldkorn,hartkorn,følehorn,sigtekorn,fuldkorn,guldhorn,sandkorn,tågehorn,pølsehorn,båthorn,valdhorn,flygelhorn,jagthorn,brødkorn,sædekorn,skohorn,truthorn,posthorn,grønkorn,signalhorn,bygkorn,tudehorn,alpehorn,frøkorn,krumhorn,såkorn,vesselhorn
3	ure	34	0.00004	32	2	procedure,brochure,frisure,ouverture,future,miniature,garniture,skure,fure,feature,turistbrochure,krummelure,plovfure,lekture,friture,manicure,pedicure,konfekture,fotogravure,mixture,korthårsfrisure,tournure,gravure,embouchure,bordure,kannelure,haute couture,joint venture,adventure,sinecure,konfiture,force majeure	garniture,joint venture
3	tro	23	0.00004	23	0	metro,tiltro,vantro,mistro,overtro,bistro,maestro,autoritetstro,intro,barnetro,tyrkertro,folketro,gudstro,kristentro,minimetro,asatro,bibeltro,skæbnetro,mandstro,gudetro,retro,klippetro,reskontro	
3	lys	42	0.00004	3	39	natlys,kongelys,brudelys	søgelys,rampelys,stearinlys,dagslys,sollys,plys,nordlys,julelys,spotlys,romerlys,blitzlys,trafiklys,blinklys,kørelys,ovenlys,blålys,modlys,månelys,nærlys,kalenderlys,vokslys,stoplys,fjernlys,bloklys,tællelys,baglys,stroboskoplys,vættelys,tvelys,positionslys,strejflys,polarlys,forlys,klys,kulbuelys,baklys,LED-lys,datolys,zodiakallys
3	nne	41	0.00004	41	0	skinne,finne,antenne,nonne,kolonne,savanne,persienne,sojabønne,kaffebønne,togskinne,bønne,rønne,parabolantenne,fællesantenne,benskinne,halefinne,hestebønne,chaconne,komedienne,busseronne,tragedienne,stangbønne,fenne,pralbønne,tappekolonne,brystfinne,bugfinne,bideskinne,gatfinne,cretonne,VHF-antenne,ferritantenne,retningsantenne,edamamebønne,snittebønne,UHF-antenne,azukibønne,strømspareskinne,bøgenonne,voksbønne,julienne	
3	nel	24	0.00004	10	14	tunnel,kanel,kennel,sænketunnel,gangtunnel,hundekennel,flannel,kornel,ritornel,flonel	panel,kanel,personel,ekspertpanel,instrumentpanel,stampersonel,kontrolpanel,fodpanel,maskinel,betjeningspanel,flannel,spørgepanel,styrepanel,flonel
3	dde	23	0.00004	23	0	rækkevidde,bredde,skildpadde,spændvidde,odde,gedde,vidde,padde,skodde,kladde,synsvidde,sporvidde,livvidde,hørevidde,sumpskildpadde,brodde,brændvidde,landskildpadde,lodde,snadde,skudvidde,fingerbredde,råkladde	
3	ælk	28	0.00004	28	0	mælk,modermælk,sødmælk,kærnemælk,kælk,kokosmælk,letmælk,skummetmælk,kakaomælk,komælk,tykmælk,minimælk,skolemælk,råmælk,gedemælk,konsummælk,sojamælk,chokolademælk,rødkælk,tørmælk,vortemælk,mandelmælk,rismælk,surmælk,svinemælk,æggemælk,ulvemælk,bittermælk	
3	træ	60	0.00004	0	60		juletræ,egetræ,frugttræ,bøgetræ,grantræ,fyrretræ,nåletræ,kirsebærtræ,birketræ,stamtræ,oliventræ,løvtræ,cedertræ,elmetræ,teaktræ,piletræ,pæretræ,asketræ,palmetræ,kastanjetræ,figentræ,lærketræ,blommetræ,limtræ,sandeltræ,klaptræ,ahorntræ,klatretræ,boldtræ,rosentræ,nøddetræ,poppeltræ,baobabtræ,gummitræ,morbærtræ,elletræ,hårdttræ,tulipantræ,eukalyptustræ,gavntræ,ferskentræ,rønnebærtræ,takstræ,naturtræ,paradistræ,endetræ,kvædetræ,råtræ,dværgtræ,febertræ,abetræ,kamfertræ,kinatræ,johannesbrødtræ,tørstetræ,blindtræ,blåtræ,fugleøjetræ,kragetræ,hængetræ
3	hør	20	0.00004	4	16	spindehør,pastichør,dispachør,retouchør	grundlovsforhør,tilbehør,ophør,forhør,gehør,genhør,krydsforhør,påhør,medhør,søforhør,tilhør,tredjegradsforhør,sytilbehør,samhør,brandforhør,totalophør
3	tog	36	0.00004	0	36		indtog,optog,korstog,tilbagetog,felttog,regionaltog,højhastighedstog,godstog,lyntog,luciaoptog,triumftog,fakkeltog,vogntog,nattog,hurtigtog,kontoudtog,intercitytog,særtog,eksprestog,strejftog,modeltog,biltog,futtog,demonstrationstog,fjerntog,ligtog,bumletog,slukningstog,udtog,sørgetog,persontog,vikingetog,motortog,iltog,interregionaltog,S-tog
3	yge	44	0.00004	44	0	syge,byge,sukkersyge,sindssyge,regnbyge,søsyge,fåresyge,elmesyge,tordenbyge,haglbyge,roskildesyge,gammelmandssukkersyge,skinsyge,køresyge,dykkersyge,behagesyge,sovesyge,legionærsyge,kyssesyge,pyntesyge,hundesyge,humørsyge,transportsyge,forlystelsessyge,omgangssyge,strålesyge,dømmesyge,månesyge,klovesyge,havesyge,papegøjesyge,herskesyge,luftsyge,trommesyge,visnesyge,hvalpesyge,fuldesyge,mund- og klovesyge,præstesyge,mosaiksyge,Parkinsons syge,regeresyge,priksyge,drejesyge	
3	lus	26	0.00004	18	8	cyklus,stimulus,bladlus,livscyklus,væggelus,linselus,gladiolus,skjoldlus,fladlus,digtcyklus,mellus,flus,kropslus,klemmelus,præstelus,konvolvolus,tømrerlus,boglus	plus,blus,vågeblus,gasblus,nødblus,spareblus,sankthansblus,åleblus
3	lån	23	0.00004	0	23		udlån,realkreditlån,boliglån,indlån,rentetilpasningslån,flekslån,forbrugslån,statslån,studielån,kontantlån,huslån,mikrolån,kviklån,byggelån,annuitetslån,blankolån,forhåndslån,biblioteksudlån,hjemlån,fremlån,lombardlån,lavrentelån,mikslån
3	ium	90	0.00004	2	88	opium,artium	konsortium,aluminium,otium,opium,millennium,palladium,sammensurium,plutonium,præludium,helium,calcium,magnesium,titanium,konsistorium,delirium,silicium,omnium,kalium,cadmium,atrium,vokabularium,natrium,polonium,thorium,iridium,elysium,herbarium,radium,skuffedarium,litium,deuterium,cæsium,mycelium,strontium,decennium,harmonium,adverbium,postludium,instrumentarium,diplomatarium,cyankalium,proprium,hafnium,ammonium,beryllium,proscenium,provisorium,barium,amfibium,rubidium,participium,niobium,osmium,polynomium,vanadium,antependium,germanium,kuratorium,indium,cerium,gallium,ytterbium,offertorium,neptunium,interludium,tallium,kolumbarium,testimonium,kalendarium,stedsadverbium,glosarium,responsorium,refektorium,dokumentarium,kolofonium,yttrium,konsilium,suspensorium,ingenium,gerundium,nobelium,eksaminatorium,mådesadverbium,bromkalium,gradsadverbium,tidsadverbium,vivarium,zirkonium
3	kon	22	0.00004	8	14	ikon,balkon,stilikon,flakon,diakon,kokon,perikon,zirkon	ikon,leksikon,karakteristikon,psykofarmakon,stilikon,konversationsleksikon,panoptikon,zirkon,onomatopoietikon,etbindsleksikon,akrostikon,distikon,emotikon,realleksikon
3	lat	44	0.00003	33	11	salat,klat,slat,kartoffelsalat,agurkesalat,undulat,spytklat,frugtsalat,mulat,pastasalat,tomatsalat,julesalat,hønsesalat,oblat,icebergsalat,sildesalat,fugleklat,karrysalat,prælat,hovedsalat,kyllingesalat,feldsalat,romainesalat,råkostsalat,waldorfsalat,snotklat,cæsarsalat,hummersalat,frisésalat,flagellat,radicchiosalat,eclat,plat	postulat,konsulat,generalkonsulat,ftalat,destillat,granulat,protokollat,hofmarskallat,korrelat,marskallat,plat
3	ænk	21	0.00003	19	2	bænk,skolebænk,anklagebænk,udskiftningsbænk,skænk,slagtebænk,pinebænk,drejebænk,slagbænk,mistbænk,høvlebænk,klaverbænk,mundskænk,sålbænk,drivbænk,filebænk,langbænk,løjbænk,revolverbænk	stænk,sølvstænk
3	vle	32	0.00003	32	0	støvle,tavle,gummistøvle,navle,opslagstavle,altertavle,fodboldstøvle,lystavle,vandrestøvle,stamtavle,mindetavle,revle,vinterstøvle,resultattavle,skistøvle,kævle,færdselstavle,træskostøvle,slægtstavle,tidstavle,basketstøvle,anetavle,snørestøvle,vokstavle,knapstøvle,fedtlæderstøvle,scooterstøvle,undertavle,søstøvle,vadestøvle,vandstøvle,votivtavle	
3	mad	30	0.00003	30	0	morgenmad,aftensmad,indmad,lokkemad,skolemad,middagsmad,natmad,ostemad,biksemad,pindemad,dåsemad,leverpostejmad,håndmad,rejemad,fedtemad,æggemad,børnemad,mellemmad,andemad,søbemad,sukkermad,fingermad,amagermad,restemad,saltmad,skemad,hakkemad,mælkemad,cafeteriamad,klapsammenmad	
3	usk	38	0.00003	26	12	busk,kusk,dusk,brusk,travkusk,frugtbusk,tornebusk,prydbusk,enebærbusk,stikkelsbærbusk,fjerbusk,ruskomsnusk,ribsbusk,tjørnebusk,hindbærbusk,kaperkusk,slåenbusk,gyvelbusk,mollusk,sirbusk,ribesbusk,skjoldbrusk,hjelmbusk,kornelbusk,ranunkelbusk,kapersbusk	sjusk,fusk,tusk,rusk,byggesjusk,valgfusk,skattefusk,lusk,snusk,citatfusk,ruskomsnusk,pjusk
3	kål	32	0.00003	32	0	skål,vægtskål,rødkål,blomkål,grønkål,hvidkål,skvalderkål,rosenkål,spidskål,koldskål,grønlangkål,glasskål,kinakål,petriskål,surkål,sukkerskål,brunkål,hofteskål,underskål,strandkål,savojkål,skylleskål,agerkål,keramikskål,kærnemælkskoldskål,blankål,margretheskål,sauceskål,langkål,velkomstskål,klosetskål,knudekål	
3	sko	36	0.00003	35	1	fiasko,træsko,løbesko,hæmsko,gummisko,kondisko,hestesko,barnesko,laksko,sutsko,hjemmesko,disko,snesko,hyttesko,sejlersko,plateausko,herresko,vandresko,damesko,travesko,pigsko,snabelsko,snøresko,golfsko,sivsko,ballerinasko,kasko,skiftesko,maosko,morgensko,kinasko,dupsko,kludesko,knapsko,remsko	varsko
3	mik	21	0.00003	21	0	dynamik,keramik,komik,polemik,mimik,rytmik,aerodynamik,situationskomik,gruppedynamik,termodynamik,biodynamik,kamik,kaffemik,lavkomik,termik,hydrodynamik,egendynamik,rakukeramik,fysiognomik,synonymik,seismik	
3	ærn	21	0.00003	5	16	kværn,peberkværn,kompostkværn,affaldskværn,saltkværn	søværn,hjemmeværn,værn,brandværn,autoværn,vagtværn,høreværn,dyreværn,børneværn,luftværn,brystværn,panserværn,landeværn,raketværn,øjenværn,bedriftsværn
3	ild	28	0.00003	21	7	sild,dild,skærsild,krydsild,morild,kryddersild,løbeild,karrysild,lynild,spegesild,helvedesild,spærreild,høstsild,saltsild,matjessild,trommeild,bidesild,astrild,flommesild,fedsild,sanktelmsild	spild,madspild,ressourcespild,stemmespild,vandspild,tidsspild,papirspild
3	ron	25	0.00003	18	7	citron,baron,perron,patron,elektron,makron,rododendron,neutron,natron,eskadron,blækpatron,gullaschbaron,skytspatron,lazaron,cyklotron,filodendron,betatron,sharon	testosteron,neuron,interferon,natron,progesteron,oxymoron,omikron
3	kød	23	0.00003	0	23		skød,oksekød,svinekød,lammekød,kalvekød,hestekød,kyllingekød,tandkød,hormonkød,halalkød,hakkekød,grisekød,flæskekød,fårekød,hønsekød,bankekød,skinkekød,mellemkød,saltkød,moderskød,småkød,kjoleskød,frakkeskød
3	ask	41	0.00003	28	13	vask,mask,håndvask,opvask,hvidvask,hjernevask,køkkenvask,storvask,snask,pandebrask,krabask,pengevask,kogevask,lask,hårvask,etagevask,maskinvask,klatvask,forvask,finvask,klarvask,kulørtvask,udslagsvask,skyllevask,hedvask,hængeask,skånevask,vådvask	bask,klask,miskmask,plask,dask,snask,sjask,damask,smask,slask,pjask,jask,atlask
3	opi	22	0.00003	22	0	kopi,utopi,fotokopi,piratkopi,filantropi,dystopi,misantropi,mikroskopi,sikkerhedskopi,entropi,koloskopi,endoskopi,laparoskopi,gastroskopi,cystoskopi,stetoskopi,rektoskopi,bronkoskopi,teleskopi,isotopi,daktyloskopi,otoskopi	
3	ræs	38	0.00003	1	37	engelskgræs	græs,citrongræs,ålegræs,juleræs,karakterræs,søgræs,karriereræs,ugræs,elefantgræs,rotteræs,kvikgræs,fuglegræs,frøgræs,rajgræs,eksamensræs,hjertegræs,fløjlsgræs,moderæs,halvgræs,kræs,rapgræs,senegræs,hundegræs,aksgræs,bjørnegræs,kanariegræs,timotégræs,stargræs,miliegræs,skavgræs,fioringræs,hvenegræs,espartogræs,hestegræs,bævregræs,kamgræs,akkordræs
3	båd	39	0.00003	39	0	ubåd,sejlbåd,motorbåd,gummibåd,redningsbåd,speedbåd,husbåd,lystbåd,fiskerbåd,robåd,slæbebåd,flyvebåd,undervandsbåd,atomubåd,kanonbåd,folkebåd,småbåd,torpedobåd,bugserbåd,turistbåd,starbåd,kølbåd,rutebåd,hurtigbåd,fragtbåd,motortorpedobåd,isbåd,konebåd,hydrofoilbåd,kartoffelbåd,ledsagebåd,luftpudebåd,tankbåd,paketbåd,bornholmerbåd,dæksbåd,bæreplansbåd,fangstbåd,udliggerbåd	
3	mse	20	0.00003	20	0	bremse,bamse,numse,nødbremse,remse,håndbremse,skivebremse,tromlebremse,fodbremse,gemse,bagbremse,hestebremse,forbremse,klamamse,festremse,fælgbremse,tokredsbremse,vakuumbremse,tælleremse,oksebremse	
3	min	28	0.00003	12	16	amfetamin,termin,jasmin,kamin,dopamin,benjamin,metamfetamin,palmin,karmin,springbalsamin,kloramin,balsamin	vitamin,amfetamin,dopamin,melamin,antihistamin,histamin,albumin,metamfetamin,nitrosamin,kloramin,E-vitamin,A-vitamin,K-vitamin,C-vitamin,D-vitamin,B-vitamin
3	lit	24	0.00002	24	0	satellit,fallit,klit,split,israelit,kosmopolit,monolit,sandklit,spionsatellit,vandreklit,havlit,bakelit,kryolit,bananasplit,zeolit,kokkolit,megalit,teodolit,TV-satellit,eolit,telesatellit,mandelsplit,prærafaelit,krysolit	
3	kar	21	0.00002	10	11	vikar,bibliotekar,lærervikar,forskningsbibliotekar,skolebibliotekar,førstebibliotekar,barselsvikar,tilkaldevikar,rigsbibliotekar,bukkar	badekar,græskar,blodkar,saltkar,lymfekar,siddebadekar,skoldekar,hårkar,bryggekar,øsekar,saltekar
3	lør	22	0.00002	17	5	kulør,klør,kontrollør,jonglør,valør,parlør,sufflør,billetkontrollør,brudeslør,trafikkontrollør,toldkontrollør,postkontrollør,modellør,ungpigekulør,malør,guldslør,ciselør	slør,røgslør,brudeslør,tågeslør,ratslør
3	tav	22	0.00002	17	5	stav,tryllestav,oktav,politistav,skistav,tiggerstav,hockeystav,bispestav,hyrdestav,gulerodsstav,æskulapstav,p-stav,agurkestav,krumstav,tøndestav,gærdestav,jakobsstav	bogstav,forbogstav,blokbogstav,kendingsbogstav,bindebogstav
3	egl	24	0.00002	19	5	negl,snegl,tegl,dræbersnegl,segl,øresnegl,skovsnegl,kanelsnegl,tånegl,vinbjergsnegl,fingernegl,strandsnegl,vingetegl,agersnegl,porcelænssnegl,purpursnegl,transportsnegl,trompetsnegl,skivesnegl	tegl,segl,laksegl,vingetegl,vokssegl
3	fly	22	0.00002	1	21	butterfly	kampfly,jagerfly,bombefly,rutefly,privatfly,jetfly,charterfly,svævefly,propelfly,ambulancefly,sportsfly,overlydsfly,trafikfly,taxafly,turbopropfly,raketfly,taxifly,tomotorersfly,enpersonsfly,firemotorersfly,underlydsfly
3	urt	37	0.00002	37	0	krydderurt,yoghurt,spurt,slutspurt,malurt,massespurt,køkkenurt,gøgeurt,pileurt,suppeurt,stenurt,salturt,sankthansurt,mjødurt,bulmeurt,jernurt,drikkeyoghurt,knopurt,hasselurt,katteurt,sæbeurt,dueurt,gåseurt,kvæsurt,høgeurt,svaleurt,bingelurt,desmerurt,gipsurt,pengeurt,tårnurt,brudurt,museurt,dyndurt,edderkoppeurt,milturt,fnokurt	
3	tan	20	0.00002	12	8	altan,satan,titan,sultan,charlatan,samaritan,platan,kaftan,tartan,butan,elastan,tarlatan	titan,metan,oktan,tartan,polyuretan,ætan,tarlatan,uretan
3	lte	34	0.00002	17	17	spalte,sylte,revolte,kulilte,multe,stylte,brintoverilte,ælte,kultveilte,volte,ilte,ganespalte,læbespalte,grisesylte,læbe-gane-spalte,smalte,svovlilte	bælte,kulilte,brintoverilte,ælte,sikkerhedsbælte,læderbælte,læbælte,redningsbælte,ilte,kyskhedsbælte,brandbælte,klimabælte,korkbælte,bindebælte,nittebælte,kalmebælte,tropebælte
3	api	23	0.00002	23	0	terapi,kemoterapi,fysioterapi,psykoterapi,genterapi,zoneterapi,parterapi,samtaleterapi,gruppeterapi,adfærdsterapi,musikterapi,beskæftigelsesterapi,ergoterapi,lysterapi,okapi,aromaterapi,gestaltterapi,fodterapi,kropsterapi,radioterapi,sorgterapi,primalterapi,bioterapi	
3	alk	25	0.00002	24	1	falk,kalk,talk,catwalk,smalltalk,peptalk,tårnfalk,skalk,vandrefalk,jagtfalk,alterkalk,valk,katafalk,hvidtekalk,tjalk,jurakalk,bryozokalk,kildekalk,fyldekalk,koralkalk,pudsekalk,duefalk,faksekalk,klorkalk	fyldekalk
3	ese	25	0.00002	25	0	tese,hypotese,syntese,protese,fotosyntese,kinese,askese,antitese,eksegese,parese,anamnese,tandprotese,brystprotese,patogenese,genese,telekinese,partenogenese,diurese,fylogenese,metatese,diatese,ontogenese,katakrese,asyndese,bolognese	
3	eme	22	0.00002	12	10	creme,solcreme,boheme,fugtighedscreme,iscreme,råcreme,skocreme,rensecreme,tantieme,pudsecreme,håndcreme,chokocreme	legeme,blodlegeme,himmellegeme,fremmedlegeme,banelegeme,varmelegeme,svulmelegeme,astrallegeme,sollegeme,meme
3	ike	27	0.00002	26	1	eddike,krønike,mountainbike,klike,nellike,sønnike,vineddike,strike,maddike,allike,røllike,kryddernellike,lookalike,ræddike,citybike,lagereddike,hike,studenternellike,tjærenellike,buddike,like,japanræddike,iseddike,kiddike,nyserøllike,bodybike	klondike
3	ian	20	0.00002	18	2	guardian,timian,slendrian,bavian,lian,median,merian,meridian,dumrian,baldrian,hessian,grimrian,morian,klodrian,grobrian,ensian,obsidian,valerian	obsidian,safian
3	fag	27	0.00002	1	26	sarkofag	samfundsfag,naturfag,linjefag,valgfag,hovedfag,kvindefag,byggefag,bifag,servicefag,enkeltfag,skolefag,mandefag,rollefag,sidefag,fællesfag,brofag,højniveaufag,grundfag,dannelsesfag,redskabsfag,værkstedsfag,socialfag,geofag,tværfag,gardinfag,p-fag
3	kse	26	0.00002	26	0	økse,galakse,akse,okse,stridsøkse,moskusokse,bisonokse,urokse,stenøkse,profylakse,isøkse,yakokse,spiralgalakse,flækøkse,jordakse,parallakse,flinteøkse,skarøkse,vandrikse,y-akse,paratakse,bisamokse,pukkelokse,hypotakse,abscisseakse,x-akse	
3	bus	21	0.00002	21	0	bybus,minibus,bambus,nimbus,bogbus,skolebus,turistbus,rebus,antabus,telebus,natbus,shuttlebus,fidibus,sovebus,ledbus,togbus,trolleybus,hurtigbus,skinnebus,kubus,lavgulvsbus	
3	iks	20	0.00002	12	8	miks,briks,biks,harpiks,kiks,appendiks,hundekiks,mariekiks,rugkiks,ostekiks,mastiks,grovkiks	miks,biks,kiks,krucifiks,appendiks,præfiks,suffiks,kniks
3	væg	29	0.00002	18	11	skillevæg,endevæg,bagvæg,ydervæg,klippevæg,klatrevæg,cellevæg,bjergvæg,skråvæg,spunsvæg,indervæg,skabsvæg,bugvæg,skærmvæg,bræddevæg,flisevæg,foldevæg,gavlvæg	kvæg,kødkvæg,malkekvæg,stemmekvæg,slagtekvæg,tamkvæg,ungkvæg,hornkvæg,jerseykvæg,herefordkvæg,korthornskvæg
3	bad	21	0.00001	0	21		blodbad,brusebad,friluftsbad,svømmebad,havnebad,søbad,vandbad,kurbad,spabad,dampbad,boblebad,karbad,solbad,fodbad,syrebad,vinterbad,styrtebad,skumbad,lysbad,sædebad,fikserbad
3	aks	31	0.00001	28	3	saks,klimaks,laks,syntaks,antiklimaks,boltsaks,vildlaks,hækkesaks,grensaks,beskærersaks,neglesaks,klosaks,rævesaks,fjerkræsaks,blanklaks,taks,lurifaks,vandaks,kogleaks,skræddersaks,sølaks,gulaks,tilskærersaks,flitteraks,vindaks,skærmaks,gydelaks,broderesaks	klimaks,antiklimaks,boraks
3	øre	28	0.00001	12	16	røre,snøre,smøre,femøre,tiøre,køre,fiskesnøre,femogtyveøre,enøre,halvtredsøre,bundsnøre,ringskøre	føre,røre,uføre,pløre,løsøre,æseløre,sprogøre,mellemøre,stritøre,køre,glatføre,skiføre,blomkålsøre,slædeføre,skøjteføre,kaneføre
3	led	31	0.00001	1	30	fælled	håndled,geled,bindeled,mellemled,slægtled,knæled,grundled,genstandsled,albueled,udsagnsled,ankelled,forled,fingerled,kæbeled,sætningsled,kugleled,førsteled,verballed,omsagnsled,kardanled,hensynsled,tåled,sidsteled,andetled,adled,kerneled,knogleled,sammensætningsled,præpositionsled,biled
3	hul	24	0.00001	0	24		vandhul,åndehul,røvhul,smørhul,smuthul,starthul,nøglehul,knaphul,fangehul,smilehul,borehul,lufthul,musehul,ormehul,kighul,glughul,mandehul,snørehul,taphul,hundehul,glamhul,langhul,spunshul,smørehul
3	rod	36	0.00001	34	2	gulerod,brod,peberrod,persillerod,græsrod,lakridsrod,kvadratrod,pælerod,skorzonerrod,håndrod,næserod,vorterod,tandrod,blærerod,nyserod,tungerod,nellikerod,gemserod,neglerod,kubikrod,hjerterod,hjorterod,svovlrod,brunrod,skælrod,trevlerod,ginsengrod,læggebrod,svalerod,ånderod,bregnerod,burrerod,giftbrod,blyrod	brod,sammenrod
3	uce	20	0.00001	20	0	sauce,tomatsauce,rødvinssauce,bearnaisesauce,chokoladesauce,kirsebærsauce,kødsauce,sennepssauce,persillesauce,skysauce,smørsauce,bechamelsauce,østerssauce,karrysauce,hollandaisesauce,champignonsauce,kaperssauce,rævesauce,løgsauce,bordelaisesauce	
3	nød	21	0.00001	21	0	hungersnød,valnød,åndenød,hasselnød,pebernød,kokosnød,muskatnød,jordnød,pengenød,tidnød,bolignød,pistacienød,cashewnød,paranød,pekannød,betelnød,stofnød,kolanød,blærenød,bræknød,rimnød	
3	lyd	26	0.00001	26	0	ordlyd,genlyd,mislyd,ultralyd,vellyd,infralyd,sproglyd,læbelyd,snorkelyd,omlyd,strubelyd,biplyd,hvislelyd,bilyd,selvlyd,tvelyd,lukkelyd,hæmmelyd,aflyd,indlyd,medlyd,næselyd,ganelyd,udlyd,forlyd,nasallyd	
3	tin	25	0.00001	13	12	nikotin,bulletin,satin,terpentin,gratin,pektin,klementin,travertin,kitin,lecitin,dentin,serpentin,fenacetin	nikotin,platin,satin,pektin,keratin,kitin,karotin,lecitin,dentin,fytin,kromatin,fenacetin
3	avl	22	0.00001	16	6	gavl,planteavl,indavl,biavl,frugtavl,svineavl,kvægavl,frøavl,pelsdyravl,kornavl,dyreavl,fremavl,kaninavl,trappegavl,klonavl,kamgavl	kravl,skravl,savl,bavl,småkravl,tavl
3	hat	26	0.00001	25	1	chat,klaphat,stråhat,paddehat,bowlerhat,østershat,bøllehat,rørhat,tyrolerhat,blækhat,svovlhat,napoleonshat,damehat,ridderhat,skørhat,panamahat,slørhat,stormhat,blåhat,mælkehat,skælhat,tragthat,highhat,parasolhat,bruskhat	entrechat
3	len	20	0.00001	11	9	skelen,sabelraslen,jodlen,metylen,triklorætylen,propylen,henstillen,alen,polyætylen,naftalen,ætylen	selen,pollen,metylen,triklorætylen,propylen,polyætylen,acetylen,naftalen,ætylen
3	olt	23	0.00000	14	9	volt,bolt,drukkenbolt,ambolt,kobolt,styrvolt,kilovolt,laskebolt,polt,pokkenholt,skruebolt,pindbolt,splitbolt,megavolt	kobolt,ibenholt,krumholt,løsholt,spændholt,rundholt,pokkenholt,friholt,retholt
3	ani	20	0.00000	15	5	mani,ludomani,onani,narkomani,megalomani,monomani,kleptomani,pyromani,nymfomani,mytomani,spillemani,erotomani,eufomani,samlemani,bibliomani	romani,litani,kapellani,hindustani,guarani
3	hår	26	0.00000	1	25	venushår	strithår,pandehår,morgenhår,pagehår,knurhår,hentehår,fehår,hestehår,kønshår,fimrehår,afrohår,pubeshår,næsehår,skæghår,rastahår,krølhår,uldhår,englehår,kirtelhår,fæhår,karsehår,øjenhår,mårhår,rastafarihår,plyshår
3	fod	27	0.00000	27	0	møntfod,talefod,levefod,forfod,klumpfod,følfod,trefod,løvefod,gåsefod,ulvefod,rentefod,mellemfod,platfod,rankefod,støttefod,elefantfod,drejefod,trykfod,svømmefod,versefod,klatrefod,bladfod,strømpefod,larvefod,sidefod,lappefod,drudefod	
3	nål	23	0.00000	23	0	knappenål,kødnål,sikkerhedsnål,hårnål,grannål,kompasnål,hæklenål,synål,fyrrenål,slipsenål,stoppenål,nipsenål,tangnål,radernål,koldnål,bøjlenål,kniplenål,orkisnål,trækkenål,ridsenål,gravernål,gimpenål,tatovernål	
4	ning	2405	0.00596	2405	0	løsning,beslutning,befolkning,mening,forening,oplysning,betydning,holdning,bygning,forventning,retning,forretning,forskning,slutning,stigning,flygtning,omsætning,undervisning,anledning,stemning,ordning,modsætning,dronning,opbakning,lovgivning,træning,omkostning,tegning,forudsætning,regning,erstatning,virkning,afslutning,ansøgning,henvisning,afstemning,betragtning,folkeafstemning,åbning,indtjening,sammenligning,bemærkning,fagforening,beretning,forvaltning,målsætning,beregning,efterforskning,underholdning,rådgivning,undskyldning,vejledning,lukning,tilknytning,begrænsning,sætning,læsning,kendsgerning,planlægning,forfatning,fortolkning,udledning,forurening,dækning,opvarmning,strækning,indretning,overvågning,satsning,lønning,udvisning,opløsning,beskyldning,opbygning,besætning,stramning,tilslutning,overbevisning,bekostning,opsætning,udbygning,udstrækning,sammenslutning,ombygning,flytning,udskiftning,påvirkning,belastning,overnatning,gerning,rygning,omlægning,prisstigning,sammensætning,bivirkning,afvisning,beskatning,sammenlægning,tænkning,udlægning,redning,indledning,udformning,lønstigning,forhåbning,foranstaltning,betjening,indspilning,tilbagetrækning,forsyning,flyvning,mobning,husholdning,svømning,lodtrækning,tolkning,ledning,nedskrivning,spredning,slægtning,rundvisning,borgerforening,tilpasning,anmodning,nytænkning,genopbygning,boksning,belønning,madlavning,opvisning,boligforening,udgravning,belysning,oprydning,genforening,oprykning,efterretning,indberetning,udlejning,pasning,betænkning,søgning,omdrejning,anvisning,genoptræning,tilbygning,omvæltning,honning,udsmykning,forelæsning,påklædning,udligning,børnepasning,nedrykning,antydning,formodning,strømning,udredning,forsoning,forstærkning,drejning,eftersøgning,gødning,afmatning,gensplejsning,udrensning,opfølgning,spisning,betalingsstandsning,lokalbefolkning,socialforvaltning,støtteforening,specialundervisning,belægning,kortlægning,undsætning,oplæsning,aflysning,statsforvaltning,overbygning,tilstrømning,dæmning,ransagning,nedrivning,opbremsning,screening,kunstforening,terning,afsætning,forordning,vælgerforening,udflytning,indvirkning,håndsrækning,handelsstandsforening,indsprøjtning,fremtoning,mærkning,civilbefolkning,opringning,beholdning,kommunesammenlægning,nævning,udstykning,blødning,beklædning,fredning,forrentning,luftforurening,hovedbygning,kursstigning,forløsning,befrugtning,vandforsyning,afskrivning,aflytning,afsoning,dyrkning,kidnapning,skabning,grundejerforening,indpakning,oprustning,afregning,forskydning,kreditforening,opstramning,udforskning,afskygning,fjernbetjening,digtning,beskydning,sænkning,skiltning,fæstning,historieskrivning,genopretning,foranledning,slagtning,nedbrydning,sprængning,ligning,happening,skydning,afstamning,hjerneblødning,fællesspisning,bombning,udrykning,ugerning,afpresning,scanning,grundforskning,urafstemning,julestemning,afslapning,rensning,videoovervågning,ensretning,atomprøvesprængning,optrapning,indskrænkning,understregning,stævning,skråning,rydning,krydsning,udstødning,visning,nedskydning,afprøvning,opsplitning,aflønning,elforsyning,grønning,oprejsning,skolefritidsordning,tilberedning,nedsmeltning,afdækning,ridning,kloning,forgiftning,svingning,efterlysning,hentydning,opkrævning,overophedning,vejrtrækning,afvejning,fortrængning,grundholdning,fremskrivning,nybygning,tiltrækning,brydning,sammensmeltning,rørledning,kulegravning,udregning,roning,styrketræning,granskning,temperaturstigning,hædersbevisning,fremvisning,omskrivning,forklædning,formaning,trosretning,opladning,afgrænsning,anretning,bearbejdning,indflytning,forplejning,skadevirkning,nedslidning,beplantning,ophængning,følgevirkning,indhegning,byplanlægning,brugsforening,ophobning,galning,kunstgødning,kassebeholdning,studieretning,efterligning,klipning,skævvridning,sansning,forfriskning,afhentning,smagning,ønsketænkning,gidseltagning,vekselvirkning,pakning,stegning,genoplivning,opblødning,tidsregning,vanetænkning,fremrykning,ladning,aflastning,bortvisning,tinglysning,udsætning,udblæsning,støbning,udmøntning,underretning,udskrivning,opstigning,kyststrækning,hæmning,bosætning,lappeløsning,forvisning,kontorbygning,lovprisning,eftervirkning,skytteforening,udpegning,skrivning,presenning,dønning,brugsanvisning,forarbejdning,selskabstømning,jobsøgning,nødløsning,genåbning,amning,selvbetjening,stening,sangskrivning,kortslutning,vildledning,fremtidsforskning,bevogtning,modregning,genrejsning,afløsning,gældsætning,tilvænning,trækning,opremsning,driftsomkostning,budgetlægning,overdækning,afvænning,rundringning,isterning,udluftning,bevoksning,aflivning,hvidvaskning,udløsning,formgivning,specialforretning,døråbning,telefonregning,forfalskning,beværtning,betoning,udrustning,hældning,fatning,syning,pakkeløsning,saltvandsindsprøjtning,ansigtsløftning,efterdønning,jobtræning,løbetræning,snerydning,fraflytning,fortrøstning,dykning,højtlæsning,lykønskning,omvisning,lovning,rejsning,telefonaflytning,gnidning,nedrustning,åreforkalkning,overbelægning,genindspilning,oprensning,læresætning,konfliktløsning,grænsedragning,fletning,sprængladning,afsmitning,prissætning,opgaveløsning,opkastning,prøvetræning,bådflygtning,lysning,vinsmagning,bombesprængning,tyrefægtning,anmærkning,opdækning,årsomsætning,mudderkastning,nedslagtning,stikning,vægtning,kassetænkning,nyfortolkning,fastfrysning,tømning,tilsætning,værdistigning,gendigtning,anordning,uddybning,vælgertilslutning,nedtrapning,trykning,modning,udladning,gisning,fægtning,sundhedsforvaltning,udklædning,standsning,forgrening,kuldegysning,rustning,bagning,overflytning,konkurrenceforvridning,indskrivning,brandslukning,bueskydning,sammenkædning,ringridning,udbringning,ordrebeholdning,overbelastning,tilflytning,slægtsforskning,afskærmning,afsmeltning,badning,gennemlæsning,seedning,aftapning,forsikringsordning,retskrivning,halshugning,røgforgiftning,byggemodning,omklædning,sæsonafslutning,landbefolkning,afklapsning,forstrækning,plantning,fældning,afbildning,benådning,skrotning,påvisning,højredrejning,olieforurening,kogning,problemløsning,tøndeslagning,krusning,håndværkerforening,hævning,træfning,voksenundervisning,sammenfatning,tobaksrygning,tøjforretning,hængning,vindretning,fordrejning,sindsstemning,kroning,juleafslutning,fordybning,brobygning,rømning,udskænkning,skatteomlægning,belåning,bespisning,fejlslutning,stavning,knopskydning,krisestemning,sammentrækning,afvæbning,tilsvining,aflæsning,nyhedsdækning,forstening,afmærkning,udbytning,vævning,stemmeafgivning,spaltning,navngivning,udlodning,forevisning,naturgenopretning,mandsopdækning,fordampning,møbelforretning,sprøjtning,livsholdning,overbefolkning,tidsbegrænsning,afledning,groning,bisætning,pressedækning,forvrængning,forhøjning,overbelåning,dumpning,præstegerning,ombytning,udvaskning,forpagtning,kvælning,oppakning,energimærkning,principbeslutning,afspilning,genhusning,overflyvning,bjergbestigning,opvågning,skiskydning,brystsvømning,krampetrækning,befæstning,fredsslutning,forplantning,opskrivning,slagterforretning,kildehenvisning,øgning,minerydning,helhedsløsning,adgangsbegrænsning,karaktergivning,pengeafpresning,hudafskrabning,låntagning,kreditgivning,skovrejsning,fordanskning,formning,støvsugning,limning,grundsætning,indflyvning,påtegning,afvaskning,opfyldning,afsøgning,udrulning,indbildning,rumforskning,nærlæsning,armbøjning,udsmidning,igangsætning,frispilning,enhjørning,udsugning,skattetænkning,vandladning,långivning,hedning,rygdækning,samordning,indskiftning,optøning,affolkning,forvridning,græsning,spidsbelastning,vandledning,hovedregning,krumning,udskridning,svejsning,nedstigning,nulløsning,blodforgiftning,vægtløftning,fibersprængning,indkøbsforening,æresbevisning,tandbørstning,nedgravning,sammenstyrtning,påpegning,såning,pladsanvisning,borddækning,afstøbning,ophugning,opgravning,håndfæstning,bøjning,grundstødning,lytning,familieplanlægning,børnetegning,stensætning,testning,nedtagning,partikelforurening,studievejledning,afhjælpning,finpudsning,anprisning,udtrækning,dræning,humørsvingning,aftrapning,tidtagning,tydning,indefrysning,køreledning,overlapning,selvforsyning,ægløsning,kønsforskning,knibning,udsultning,indramning,soning,slukning,farvning,fjernundervisning,braklægning,sportsforretning,bestøvning,piskning,bredning,magtfordrejning,saltning,kropsbygning,hovsaløsning,fortøjning,stuvning,gennemspilning,historieforfalskning,tegnsætning,vejning,åreladning,nedfrysning,programlægning,sidebemærkning,nyordning,aftegning,langtidsvirkning,skattesænkning,tilbagelægning,genopsætning,udskilning,inddæmning,sociallovgivning,syltning,eftersidning,blindsmagning,skåning,omstigning,kodning,sangforening,helsekostforretning,stikledning,sammenføjning,genoptrykning,tildækning,feberredning,helleristning,gennemstrømning,brolægning,fedtsugning,sektorforskning,skønhedsdronning,blomsterforretning,standerhejsning,slibning,heltegerning,forfrysning,udsivning,bevæbning,skovrydning,opdyrkning,bjergning,forstuvning,brygning,misfarvning,nedbremsning,udplantning,udpumpning,ibrugtagning,rådslagning,fejlfortolkning,lagerbeholdning,armlægning,strikning,fartbegrænsning,tapning,retsvirkning,støjdæmpning,forvanskning,optræning,nedstyrtning,sidebygning,forkalkning,dobbeltbeskatning,undergravning,lavning,prøvesmagning,kørselsretning,afholdsforening,hvervning,udjævning,urbefolkning,træfældning,øremærkning,kunstretning,forgyldning,nedlægning,begravelsesforretning,nedkastning,drukning,afhopning,nedsivning,afpudsning,kvoteordning,fyldning,pløjning,solskoldning,ridebanespringning,indtastning,retsforfølgning,søsætning,fremlægning,hashrygning,sammenskrivning,intervaltræning,udslusning,rangordning,tilretning,enkedronning,forlægning,prægning,levning,afkortning,lejerforening,fortætning,proportionsforvrængning,krængning,afklædning,genforskning,indhentning,indfangning,fugleskydning,slankning,glidning,tæmning,lynchning,iltning,trimning,strygning,indvejning,farvelægning,overfortolkning,påfyldning,bybefolkning,konfirmandundervisning,udtagning,plukning,smeltning,gradbøjning,linning,udflagning,misgerning,tandlægeregning,ætsning,drømmetydning,afdæmpning,podning,malkning,aldersspredning,sletning,erhvervsvejledning,dæmpning,privatundervisning,karriereplanlægning,ruteflyvning,kvægbesætning,losning,udposning,afgræsning,optankning,afskovning,konsekvensberegning,gødskning,klædning,fritvalgsordning,afrensning,omregning,genlæsning,stregtegning,miljømærkning,sammenfletning,udsoning,kostvejledning,langtidsplanlægning,venstredrejning,patentløsning,nedrakning,delikatesseforretning,hovedsætning,græsslåning,forkastning,bestigning,tekstning,indslusning,pligtlæsning,tagdækning,interessemodsætning,regeringsbeslutning,skadeserstatning,nedkæmpning,efterregning,naturfredning,fleksjobordning,indstigning,bouillonterning,afskalning,afgiftning,gennemskrivning,ringning,afkodning,indløsning,omformning,familierådgivning,tovtrækning,luftning,udskibning,dragning,omplantning,hjemmefødning,jævning,snoning,overspisning,forventningsafstemning,fastlåsning,frysning,udstigning,konfliktforskning,lægning,vanskabning,oprulning,opslutning,opregning,brevskrivning,lynchstemning,springning,datomærkning,gæsteforelæsning,gestaltning,vækning,støjforurening,udfyldning,overstregning,nyplantning,opfedning,mavebøjning,tilplantning,indrykning,elevsammensætning,nedtoning,bibellæsning,fejllæsning,drageflyvning,gipsafstøbning,afstivning,inddækning,indkredsning,terminalbygning,bremsning,tolærerordning,presning,kontantbeholdning,tuning,opretning,overfiskning,flugtning,optjening,gravning,hulning,underlægning,planløsning,opvartning,formening,iklædning,mentaltræning,brændemærkning,brandbeskatning,sandblæsning,nøgenbadning,bandlysning,splejsning,forlængerledning,tilvirkning,gennemlysning,flagning,tuschtegning,stilretning,blegning,landsætning,misstemning,hudfletning,indtrængning,medskabning,charterflyvning,lastning,tilrettelægning,rygsvømning,opredning,ledsætning,slåning,misvisning,ældning,strafforfølgning,modforanstaltning,rygeafvænning,filtning,modestrømning,sprogforskning,lugning,udhængning,lysvirkning,svæveflyvning,synkronsvømning,oparbejdning,fejltolkning,beslutningstagning,rudeknusning,modtagning,indregning,personlighedsspaltning,kystbevogtning,opfriskning,kalkning,trossætning,midterskilning,prøvning,seksualoplysning,æglægning,bruning,tæppebombning,udpining,straffeforanstaltning,knæbøjning,æresoprejsning,ringmærkning,rumflyvning,afskydning,skylning,hærdning,lystlæsning,øvning,indsugning,afskibning,tankning,kattedronning,efterslukning,ristning,fygning,ferielukning,pudsning,tilgroning,tilbudsgivning,indeslutning,kædeforretning,påstigning,glatstrikning,kaproning,halalslagtning,sumobrydning,bøsning,maskinskrivning,anskydning,fejning,sløjfning,afrustning,slyngning,sambeskatning,røgning,gennemsøgning,indfatning,opmærkning,nytegning,forflytning,indbygning,hjemtagning,krydsklipning,rulning,udtømning,afrusning,pålæsning,skyggeboksning,byggeforening,skibssætning,tiltalerejsning,underbygning,udpakning,aftjening,skilning,nyttevirkning,turnusordning,lodning,toning,merindskrivning,følgeslutning,gentænkning,cirkelslutning,kabellægning,kvælstofudvaskning,retstavning,genudlejning,systemtænkning,indstrømning,frostsprængning,erindringsforskydning,armvridning,afhugning,skibsladning,skovning,ørkenspredning,husgerning,tipning,tilrettevisning,rivning,tætning,pyntning,boliganvisning,brugsvejledning,velgerning,udstrømning,frastødning,brugervejledning,sminkning,sammenplantning,forbytning,genopfriskning,foldning,udviskning,sortlistning,omsmeltning,klimamålsætning,genopladning,sammensyning,udgrænsning,indlæsning,atomsprængning,prøvetagning,kristning,sammenknytning,knusning,køreretning,tilskrivning,kickboksning,tilspidsning,indpasning,mørkning,bytning,universalløsning,flugtskydning,omfortolkning,lyddæmpning,fogedforretning,skygning,vejbygning,kraftudladning,afblæsning,opbagning,vedhæftning,gesvejsning,rigning,opstemning,lønglidning,afkrydsning,indtjekning,færdighedsregning,skemalægning,medieforskning,pantsætning,lapning,udretning,udspaltning,drikning,drivning,isenkramforretning,flytteforretning,opstaldning,støjafskærmning,udklækning,grusgravning,frilægning,afkalkning,dalsænkning,udfletning,socialforskning,prismærkning,bagbygning,omladning,retledning,fortegning,kørselsvejledning,sjipning,opbrydning,kvælstofforurening,tolvmandsforening,underordning,refleksredning,afstribning,misfortolkning,gasning,overfusning,genoprustning,vridning,kreditoplysning,sammenvoksning,maveforgiftning,skoldning,forskansning,oplægning,eneundervisning,liveindspilning,mætning,bagbeklædning,frihåndstegning,begroning,lynghonning,indfarvning,afretning,optegning,tygning,afstresning,anlægning,nedsænkning,frugtsætning,blodstyrtning,overtræning,mistolkning,blækregning,hårfjerning,trøstespisning,udspredning,isætning,tilsmagning,naturgødning,tilsmudsning,ophedning,uddunstning,tørlægning,begynderundervisning,pottetræning,udskamning,sammenklipning,brandskatning,børnebegrænsning,nødforanstaltning,afstødning,afsyngning,arbejdsanvisning,andengradsligning,afstrømning,fredsforskning,opdæmning,forkortning,grundvandssænkning,indblæsning,udfladning,afdrypning,påsætning,regionplanlægning,udtoning,tegngivning,udskrabning,afgasning,afkristning,statsforfatning,oppustning,krigsskadeserstatning,afbøjning,bibetydning,tykning,brøkregning,snifning,forfølgning,kommunalforvaltning,blotlægning,udpantning,pælesidning,taxaflyvning,forblødning,mundaflæsning,klækning,gydning,skrælning,udspilning,finkæmning,brancheglidning,isning,mildning,mindskning,optagning,overtegning,smagsretning,dødning,suppeterning,afisning,bugtning,ombrydning,tilstopning,dampning,æltning,tonesætning,udskylning,understrygning,helsætning,understøtning,måleraflæsning,venneanmodning,sammenklumpning,skiftning,tækning,bristning,toplønning,bidronning,systemdigtning,indsætning,stabelafløbning,udblødning,udlugning,underskrivning,tvangsudskrivning,studsning,overisning,afrydning,afslibning,hegning,nakkefoldsscanning,smedning,postopkrævning,pumpning,omringning,fræsning,akvaplaning,grebning,troppeopbygning,blodudtrædning,garvning,rørlægning,aflusning,udskældning,fremhævning,beflyvning,langtidsstegning,iblødsætning,turboladning,sammenstykning,grillstegning,tagrygning,udstopning,gennembrydning,klarlægning,fortidslevning,afgravning,delbetænkning,krydshenvisning,sejlretning,lodsning,særbeskatning,skeetskydning,fejlsøgning,henkogning,omskiftning,forsænkning,tandfyldning,fugning,gennembankning,aflukning,gennemtænkning,neddykning,indfrysning,indordning,fremlysning,sætningsbygning,fribrydning,saligprisning,simultantolkning,sammenpresning,opsugning,omtolkning,udspørgning,kostforplejning,fortoldning,isskruning,gennemblødning,sammensvejsning,penning,gunstbevisning,kværkning,forlening,afblegning,landsplanlægning,styrtblødning,læseforskning,helseforretning,hedestigning,omstyrtning,afladning,søvnforskning,berigning,bestykning,indtagning,afdampning,udprintning,sugning,bedækning,agerdyrkning,randbemærkning,forsumpning,integralregning,børstning,sidehenvisning,husning,hvidevareforretning,kløvning,udfældning,slamsugning,affejning,slotsaftapning,knytning,hårfarvning,samlæsning,vandbygning,differentialregning,kaprustning,håndgerning,forgasning,gennembladning,ergometerroning,friturestegning,udbening,udrugning,gennemarbejdning,nedfældning,udglatning,bortlodning,tobaksafvænning,tillempning,navneforskning,renskrivning,indtegning,rentegning,dagning,overspilning,indlægning,bagklædning,skønsforretning,perspektivtegning,sammenstuvning,fantomredning,sammenrotning,skrumpning,krympning,udmugning,rugning,genkristning,delløsning,udskydning,gennemprøvning,programsætning,totalfredning,skopudsning,ombetrækning,afstigning,syrning,flåning,gennemregning,viktualieforretning,udringning,afstøvning,omkodning,afbødning,babysitning,opsøgning,armstrækning,hundesvømning,gravsænkning,modelflyvning,omlæsning,natsænkning,medbetydning,skrinlægning,udstregning,minesprængning,bibemærkning,pålægning,spontanflygtning,tildigtning,terminsforretning,savning,kransenedlægning,tærskning,overbrusning,mandjævning,sprøjtestøbning,hejsning,forkromning,aflåsning,hakning,hyldning,synstolkning,opstamning,fortyskning,rendyrkning,måltagning,yderbeklædning,kantning,undergerning,indkogning,hjertestyrkning,blisterpakning,låsning,størkning,neddæmpning,høstning,afskrabning,sammenhobning,taleundervisning,profboksning,retstrikning,kælvning,afventning,indsivning,udtænkning,opklodsning,tekstanmærkning,renvaskning,gennemtrængning,fladsyning,forsølvning,stjernetydning,anflyvning,diegivning,skoleridning,paraglidning,brystning,indkrævning,fraspaltning,hedebosyning,velcrolukning,affugtning,omberegning,anknytning,knaplukning,postanvisning,knæløftning,udsættelsesforretning,svidning,stopning,overskrivning,særforplejning,kurvefletning,begitning,inddampning,underspilning,opbringning,indfletning,andenhåndsberetning,efterabning,tendenslodtrækning,tekstfortolkning,bejdsning,knoglebygning,sammenrodning,standerstrygning,fingersætning,fravænning,medvirkning,indøvning,indskibning,afrivning,radiospredning,opdrætning,skiveskydning,skruning,dybfrysning,varmforzinkning,fritekstsøgning,udhugning,gennemhulning,udlæsning,hvidtning,lånoptagning,snitning,radarovervågning,guldgravning,betingning,formuldning,udkrængning,kastning,løftning,rykning,udstikning,nedspilning,skarpskydning,aflægning,gennemtrumfning,overtoning,tørsvømning,konditræning,afstumpning,opslugning,lynstegning,kagstrygning,klapning,opklæbning,tilbagerykning,printning,tillukning,gennemstegning,grusning,harskning,udfoldning,bodytoning,vakuumpakning,bomning,sværtning,genskabning,spidning,skyggelægning,madning,periodelæsning,åndemaning,udkastning,oversprøjtning,vellystning,indridsning,bukning,hypning,ilandsætning,våning,relativsætning,nedramning,tredjegradsligning,personskadeerstatning,opløftning,gennemsivning,minestrygning,gentegning,taxiflyvning,frilæsning,pletrensning,skrubning,indkodning,lytterforening,gennemluftning,jordledning,aftagning,underforsyning,skafning,stækning,optrækning,smocksyning,affedtning,tilridning,eftervisning,overfyldning,headning,selvbefrugtning,inddrivning,optrykning,familievejledning,indflagning,dobbeltholdning,blæsning,ilægning,drøvtygning,neddypning,miksning,oppiskning,påligning,overstrygning,harvning,pilning,opskruning,snetykning,sysselsætning,indstregning,opridsning,afskrælning,godskrivning,brystscreening,omdigtning,rentesregning,muskelsprængning,flænsning,udbombning,sideordning,gennempløjning,opfiskning,nedstemning,drypning,forstøvning,indarbejdning,vipning,sigtning,indskydning,naboovervågning,forrykning,grutning,merbeskatning,oversavning,forkulning,mæskning,fralægning,renholdning,forpakning,takning,uhyggestemning,skoning,indstøbning,affarvning,ompotning,udhævning,udsmeltning,skumning,indskrumpning,forpupning,gravsætning,forvarmning,fejlskrivning,oplivning,stepning,overhældning,udlovning,maltning,kontrolopringning,afkastning,afbrækning,indgnidning,forsætning,afspisning,hjemmebrygning,ophjælpning,fortykning,mørning,kalvekastning,fratrækning,afspaltning,glaspustning,konturtegning,kitning,stileskrivning,frasætning,særskrivning,bundfældning,flydning,blodsænkning,synkning,sagsøgning,inddragning,ionbytning,notarialforretning,afkogning,gruppesammensætning,indelukning,indprentning,ridsning,indhøstning,herreklipning,slæbning,sprogrensning,målforskning,sammenstikning,tilhugning,indpodning,lysestøbning,opvejning,infinitesimalregning,tiltning,blindflyvning,mørkelægning,berapning,tilisning,nedstamning,stambesætning,befugtning,indpiskning,affedning,dampkogning,indenadslæsning,kølsprængning,bortkastning,forudberegning,ombukning,udslyngning,skrabning,løbning,minesøgning,gravlægning,bortledning,gramfarvning,udartning,folkemindeforskning,sammenfoldning,omkredsning,afsvidning,skridning,overklipning,foresyngning,sønderrivning,dypning,omprøvning,lynladning,kasusbøjning,løsrivning,synsforretning,følgesætning,nådesbevisning,udtydning,påtrykning,opflamning,fraskrivning,afstikning,fremskydning,topbelastning,undertegning,tilgrisning,gætning,fejlhuskning,tørstegning,bestrygning,opsvulmning,varmrøgning,opstøvning,udlosning,udpibning,afbarkning,hjemflagning,rusmiddelforskning,udpresning,maskinstrikning,frontbetjening,mønning,stillelæsning,autoopretning,afrigning,afskumning,boning,begramsning,tagunderstrygning,åreforfedtning,udæskning,gipsning,gennemrodning,typetegning,radiomodtagning,rødning,verbalbøjning,bestænkning,tilraning,slæmning,klining,klarning,overdængning,hysning,købslagning,aftrykning,underdrejning,hensigtsledsætning,ribstrikning,dobbeltbrydning,udfritning,klemning,dagbrækning,processkrivning,døgnåbning,overskylning,snekastning,dropning,sønderlemning,afhudning,indklipning,skønskrivning,sammensnerpning,afæskning,eksponentialligning,NPK-gødning,førstegradsligning,fleksning,indankning,udstansning,tintning,opvridning,indbytning,kortgivning,klinkbeklædning,teltslagning,bølgning,svævning,skætning,afridsning,udklasning,glitning,anduvning,vantrivning,hjemskrivning,mr-scanning,snorkning,omarbejdning,fremmaning,de facto-flygtning,enkeltskrivning,betrækning,opsprætning,afbremsning,udvejning,rundstrikning,trefagsordning,medtagning,udgroning,nejning,nedsaltning,klapsning,skøjtning,glatning,bajonetfatning,ombøjning,afplukning,eftermodning,tilhylning,buskning,skalkning,omramning,grønsaltning,forzinkning,temperaturtagning,grilning,afgnavning,følgeledsætning,afhøstning,afhærdning,brakning,indsæbning,skodning,afgivning,slækning,kølning,opflaskning,rokning,sammenrulning,sengevædning,indstævning,kurssætning,beredning,ballepresning,hudstrygning,nikotinforgiftning,raspning,hærgning,valkning,selvaflæsning,potning,TV-overvågning,permanentbølgning,gimpning,kardiotræning,schæchtning,omrystning,indesnening,rørfletning,kønsbøjning,opsmøgning,plejning,udrivning,sopning,reolpløjning,mejetærskning,indterpning,afsvækning,tastning,rynkning,indfortolkning,trådning,fasning,ensartning,halvflugtning,forskrivning,matchning,gælning,anløbning,faxning,gasrørsledning,sammentrædning,regionalplanlægning,prajning,skæftning,forulempning,fredlysning,afdrivning,opdigtning,sankning,kradsning,indhæftning,forløftning,steptræning,tilforordning,skumlæsning,hugning,afhaspning,møgspredning,hensigtssætning,indladning,damprensning,kronesænkning,gatåbning,opspædning,skjortelinning,tilkastning,prøvefilmning,indslibning,afglatning,svumning,styning,besprøjtning,grusspredning,fornorskning,kviltning,skriftstøbning,fotosætning,tværretning,trædning,sammenslyngning,kuldkastning,rinkning,afbladning,minusløsning,udsavning,afgrening,strømlining,elementærundervisning,lægtning,skvisning,fremelskning,underslåning,stakning,totrinsløsning,indgiftning,fuldtekstsøgning,pisning,miljøprøvning,sammentrængning,prohibitivpåtegning,isprængning,aftrædning,berejsning,styrtning,uddragning,plotning,opelskning,omdøbning,stansning,kobberstikning,helflugtning,underdønning,zapning,buning,stregning,fugtning,opfangning,slidsning,palning,styrtdykning,nuludledning,omfatning,afløvning,flængning,tryning,rining,SMS-afstemning,afkvistning,præfiksafledning,pilkning,oplistning,spørgesætning,brusning,brækning,gennembagning,krakning,indsnusning,kredsning,sammenrystning,flammesvejsning,mugning,overspringning,in vitro-befrugtning,bootning,antegning,udmatning,gyngning,formumning,lænkning,bundtning,filmning,CT-scanning,stødning,afpasning,fremtrylning,indplantning,fortinning,dirkning,patentudtagning,lavtflyvning,elektrosvejsning,propning,g-påvirkning,stænkning,opstandsning,tillavning,kapning,sinkning,vandtrædning,sammenrykning,fragtning,opslæmning,kenning,klunsning,forpestning,pløkning,haspning,indsænkning,tragtning,tilpropning,fribadning,ilandbringning,gennemvævning,tofagsordning,hægtning,afmejning,bogtilrettelægning,materialeprøvning,sivning,malning,nedslagning,pantning,læmning,afkrævning,sødning,gangning,boykotning,eftermørkning,dameklipning,laskning,sejtrækning,opsnapning,svajning,tampning,drysning,teltning,råsyltning,lixning,skødning,knopning,strengning,udludning,rentrykning,røgtning,kalvning,blokning,selvplukning,listedækning,affladning,indbagning,afrømning,stivning,persning,svejfning,speakning,valsning,viskning,kipning,krabning,hæftning,færgning,stileretning,bænkning,sidsteøjebliksløsning,indføjning,skelsætning,kærning,lokning,dolkning,stiftning,social- og sundhedsforvaltning,tilordning,forkrøpning,skulkning,indsyngning,omslutning,isyning,saftning,rebning,udtolkning,patning,splidsning,bælgning,kommissionsforretning,affødning,afbrydning,forgrovning,afgnidning,sining,e-learning,forskubning,mineoptagning,forbening,nedmejning,udrømning,årsagssætning,roduddragning,radsåning,udtrætning,personsøgning,udsvedning,udsprængning,tidssætning,autogensvejsning,lækning,påankning,overlydsflyvning,ordføjning,tovning,oversidning,spytning,fønbølgning,trængning,årsagsledsætning,afsminkning,læskning,omslyngning,perspektivplanlægning,fremdragning,afnakning,overrækning,grundværdistigning,væbning,afvalmning,høbjergning,udlåning,stagning,mejning,kvældning,dupning,stængning,udkragning,landskampsstemning,stubfræsning,koldrøgning,opgivning,klinkning,vaffelvævning,brankning,stolpelukning,hårrørsvirkning,krybning,udgranskning,diagonallæsning,indfældning,patentstrikning,indhugning,udkæmpning,afhorning,panamavævning,forholdsregning,krepning,flødning,ophøjning,ruskning,gnavning,budgivning,fremlejning,pointberegning,forforstærkning,pelsning,spinning,kobberforhudning,udarbejdning,tvætning,lænsning,skærpning,logning,startomkostning,grøftning,doksætning,knæsætning,kobbertrykning,uddykning,spidsning,CO₂-udledning,fortoning,islægning,spækning,udkerning,indstikning,guidning,vugning,notning,opslidning,afsæbning,idriftsætning,rystning,dokning,ifyldning,gennemløbning,afgrøftning,tilskødning,forslumning,uddrivning,forsvenskning,udsøgning,spørgeledsætning,tale-høre-undervisning,flosning,stampning,rapning,friskning,fordakning,tiltuskning,afrimning,overkogning,udsaltning,afpropning,overøsning,aftjekning,børneklipning,udspejdning,vinddrejning,bulkladning,kæmning,udarmning,fedronning,stribning,zoomning,temalæsning,underbefolkning,indhakning,interviewning,tangforløsning,tidsledsætning,rendegravning,bladning,udmajning,toldforretning,krølning,hensætning,grønthøstning,hofholdning,letning,opkvikning,ribning,ct-scanning,varpning,duvning,strøbemærkning,permanentkrølning,afbagning,klæbning,forhudning,individualundervisning,udblokning,falmning,bestrøning,tohåndsbetjening,gysning,hvæsning,knapning,fedning,byggeomkostning,turtagning,istemning,overskygning,kløftning,falsning,forskruning,overhedning,opstrengning,målsøgning,indvævning,rebslagning,skanseklædning,udbankning,udfasning,kompostgødning,gildning,indfasning,vedtegning,sammenfældning,kridtning,indlemning,TV-sening,rejfning,kransning,flådning,splitning,gafning,lunkning,grydestegning,forfranskning,drilning,stangning,forstemning,afspritning,oldtidslevning,pustning,klaverforretning,fremkaldning,udmarvning,udstening,dobbeltskrivning,MR-scanning,hjemme-PC-ordning,indprægning,henledning,tyndslidning,nitning,kælkning,afblankning,snefejning,afskridtning,spunsning,lempning,prikning	
4	else	1362	0.00546	1338	24	forbindelse,undersøgelse,uddannelse,ledelse,bestyrelse,oplevelse,begyndelse,følelse,indflydelse,størrelse,opfattelse,bevægelse,afgørelse,forståelse,udtalelse,besparelse,tilværelse,fornemmelse,anmeldelse,henvendelse,betingelse,deltagelse,ydelse,overraskelse,omgivelse,forbrydelse,optagelse,tilladelse,beskæftigelse,undtagelse,udvidelse,begrundelse,overvejelse,udsendelse,beskrivelse,udgivelse,opgørelse,pressemeddelelse,anvendelse,beskyttelse,lidelse,fornøjelse,ansættelse,skikkelse,anelse,meddelelse,redegørelse,forpligtelse,øvelse,anerkendelse,skattelettelse,betegnelse,erkendelse,forberedelse,oversættelse,besættelse,forlængelse,bekæmpelse,fagbevægelse,bestræbelse,skuffelse,bestemmelse,styrelse,overensstemmelse,opførelse,kommunalbestyrelse,besiddelse,tilstedeværelse,godkendelse,hændelse,forsinkelse,dannelse,overtrædelse,anholdelse,misforståelse,fornyelse,opdagelse,indførelse,oprettelse,begravelse,lettelse,overlevelse,hukommelse,overtagelse,offentliggørelse,vedligeholdelse,sigtelse,oprindelse,efteruddannelse,opholdstilladelse,iscenesættelse,drøftelse,udbredelse,forebyggelse,udnyttelse,gentagelse,kendelse,ødelæggelse,opfindelse,vedtagelse,udnævnelse,modtagelse,undertrykkelse,anstrengelse,oversvømmelse,indrømmelse,krænkelse,bebyggelse,bedømmelse,fejltagelse,opdragelse,splittelse,afskaffelse,befrielse,afskedigelse,opfyldelse,fortsættelse,forargelse,styrkelse,gennemførelse,bekendtgørelse,indvielse,fristelse,indsigelse,henrettelse,beføjelse,udfoldelse,nedsættelse,erhvervsuddannelse,forringelse,nydelse,bestikkelse,bosættelse,indlæggelse,antagelse,læreruddannelse,forfølgelse,skabelse,velsignelse,arbejderbevægelse,forhøjelse,modstandsbevægelse,berømmelse,forelskelse,forudsigelse,selvforståelse,ydmygelse,skolebestyrelse,tilføjelse,adskillelse,lempelse,udførelse,opsigelse,iagttagelse,ophævelse,nyskabelse,nedlæggelse,frelse,fordømmelse,forkortelse,uoverensstemmelse,tilkendegivelse,fordybelse,misundelse,udarbejdelse,krigsforbrydelse,kvæstelse,gengivelse,løsladelse,stiftelse,udsættelse,berettigelse,besvarelse,forøgelse,bekræftelse,politianmeldelse,fjernelse,tilgivelse,forbandelse,påmindelse,medfølelse,bevarelse,forsørgelse,udvælgelse,bekendelse,fortvivlelse,opstandelse,tilblivelse,forseelse,svækkelse,frigørelse,forstyrrelse,vielse,frifindelse,serviceydelse,indsættelse,rettelse,beklagelse,ærgrelse,bortførelse,armbevægelse,forlystelse,godtgørelse,inddragelse,overskridelse,selvangivelse,prøvelse,overdragelse,anbringelse,indlevelse,tilnærmelse,indtagelse,understøttelse,beboelse,tilståelse,overdrivelse,lovovertrædelse,skrivelse,afbrydelse,rystelse,folkebevægelse,dyrkelse,fornærmelse,afvigelse,tjenesteydelse,lønforhøjelse,krigsførelse,selvbestemmelse,tilfredsstillelse,byfornyelse,anseelse,videreuddannelse,byggetilladelse,magtovertagelse,mindelse,spiseforstyrrelse,udryddelse,hørelse,udelukkelse,angivelse,begavelse,videooptagelse,selvransagelse,hjemsendelse,frigivelse,hensættelse,forsendelse,løsrivelse,fremlæggelse,udskejelse,tilrettelæggelse,universitetsuddannelse,bisættelse,skærpelse,overholdelse,istandsættelse,sammensværgelse,helbredelse,indgåelse,nyhedsudsendelse,tilskyndelse,retsforfølgelse,lungebetændelse,skyldfølelse,tiltrædelse,fastholdelse,udtagelse,arbejdsnedlæggelse,fortrydelse,udmærkelse,forkyndelse,afstraffelse,tykkelse,betændelse,optegnelse,forbløffelse,genudsendelse,afholdelse,udmeldelse,forretningsforbindelse,forundersøgelse,frihedsberøvelse,forskrækkelse,udstedelse,lammelse,omdannelse,oprørsbevægelse,indkaldelse,forkølelse,bemyndigelse,opretholdelse,selvopfattelse,hjernerystelse,eksistensberettigelse,anskaffelse,genoptagelse,færdiggørelse,udskydelse,overrækkelse,ængstelse,grunduddannelse,kvindebevægelse,medbestemmelse,brandstiftelse,jordforbindelse,forsømmelse,børneopdragelse,grundlæggelse,berigelse,opsendelse,bogudgivelse,indbydelse,videreførelse,uropførelse,anskuelse,domsafsigelse,skatteforhøjelse,fortielse,tvangsfjernelse,frakendelse,genkendelse,selvfølelse,bedøvelse,modydelse,blodsudgydelse,modsigelse,forlovelse,udslettelse,forældrebestyrelse,mistænkeliggørelse,bevisførelse,internetforbindelse,fratrædelse,vildfarelse,mavefornemmelse,nedbringelse,underskrivelse,bearbejdelse,omfavnelse,kerneydelse,forfremmelse,anlæggelse,dommerkendelse,vækkelse,ildspåsættelse,erhvervelse,livsførelse,ophidselse,domfældelse,akutmodtagelse,forskønnelse,skoleledelse,stavelse,udøvelse,tilbageholdelse,fastsættelse,fredsbevægelse,medindflydelse,varetagelse,udmattelse,trosbekendelse,lignelse,forførelse,frembringelse,udskrivelse,helse,genindførelse,besværgelse,beslaglæggelse,selverkendelse,latterliggørelse,diplomuddannelse,overgivelse,underdrivelse,væmmelse,prøveløsladelse,benægtelse,hævelse,besindelse,solformørkelse,indskydelse,selvmodsigelse,fremmedgørelse,afgivelse,selviscenesættelse,underkastelse,overværelse,håndhævelse,fritagelse,genanvendelse,gengældelse,benyttelse,nationalfølelse,forkælelse,genudgivelse,foreteelse,inddrivelse,retsfølelse,anfægtelse,radioudsendelse,misdannelse,beherskelse,forbavselse,miljøbeskyttelse,boligydelse,forstoppelse,andelsbevægelse,påskønnelse,opinionsundersøgelse,irettesættelse,fortabelse,retskendelse,kødannelse,korsfæstelse,opgivelse,lemlæstelse,indfrielse,ankestyrelse,fordrivelse,tilsidesættelse,udstødelse,efterfølgelse,omvendelse,forglemmelse,genopstandelse,adspredelse,fornedrelse,bestyrtelse,sindslidelse,fornægtelse,nyerhvervelse,indlemmelse,sendetilladelse,kraftanstrengelse,afbenyttelse,hospitalsindlæggelse,fordøjelse,forfærdelse,lægeundersøgelse,tilegnelse,magtbeføjelse,båndoptagelse,bebrejdelse,virkeliggørelse,bagvaskelse,mentalundersøgelse,betagelse,naturbeskyttelse,fællesbetegnelse,tilfangetagelse,fortegnelse,iværksættelse,benovelse,tilbedelse,tildragelse,beruselse,helårsbeboelse,boldbesiddelse,indmeldelse,agtelse,stivelse,hengivelse,nævnelse,helbredsundersøgelse,brugerundersøgelse,røgelse,forrådnelse,telefonforbindelse,fastlæggelse,livsanskuelse,ledsagelse,situationsfornemmelse,forældelse,præmieoverrækkelse,besigtigelse,tilintetgørelse,renselse,udskillelse,udeblivelse,strømafbrydelse,opnåelse,forråelse,fremførelse,spareøvelse,tilsnigelse,voksenuddannelse,overvindelse,udgydelse,genskabelse,kvababbelse,lovliggørelse,forhånelse,formørkelse,genopførelse,leverbetændelse,lykkefølelse,totaloplevelse,nyoversættelse,fratagelse,bibeskæftigelse,undfangelse,fastansættelse,ligeberettigelse,hemmeligholdelse,halsbetændelse,fortryllelse,omgåelse,hæftelse,ansvarsforflygtigelse,bortskaffelse,misligholdelse,taksigelse,frikendelse,benævnelse,basisuddannelse,fremhævelse,forbitrelse,træbeskyttelse,forstillelse,afskrækkelse,nedkæmpelse,fremsættelse,billigelse,varebetegnelse,færgeforbindelse,afsendelse,udeladelse,fortalelse,genoprettelse,forladelse,syndsforladelse,fremkaldelse,personlighedsforstyrrelse,kildebeskyttelse,overtalelse,afsættelse,igangsættelse,verdensopfattelse,forarmelse,forflyttelse,beroligelse,rejsebeskrivelse,forhåndsgodkendelse,efterlevelse,umyndiggørelse,pågribelse,afståelse,stadfæstelse,beskuelse,mytedannelse,endelse,nyanskaffelse,pligtforsømmelse,begunstigelse,selvbeherskelse,blottelse,retfærdiggørelse,overstørrelse,ghettodannelse,arbejdsmarkedsuddannelse,hadforbrydelse,forelæggelse,forkastelse,indholdsfortegnelse,sikkerhedsstillelse,interviewundersøgelse,fuldbyrdelse,fordyrelse,overanstrengelse,pligtfølelse,indskærpelse,genopdagelse,smørelse,førsteopførelse,eftergivelse,imødekommelse,blindtarmsbetændelse,beskikkelse,henrykkelse,fingerspidsfornemmelse,underkendelse,almendannelse,husførelse,forstørrelse,tilbagekaldelse,korttidshukommelse,indsendelse,forherligelse,faderskikkelse,strafskærpelse,undladelse,opofrelse,misbilligelse,bevidstgørelse,uddrivelse,aflæggelse,betroelse,tvangsindlæggelse,legemsbeskadigelse,indrejsetilladelse,renholdelse,strækøvelse,selvhævdelse,drikkelse,nydannelse,blærebetændelse,bagtalelse,tilbagesendelse,rørelse,foryngelse,udfrielse,retshåndhævelse,påbegyndelse,genopdragelse,henlæggelse,måneformørkelse,kristenforfølgelse,gudsdyrkelse,berigtigelse,opbyggelse,afhændelse,udfærdigelse,påberåbelse,synsforstyrrelse,festligholdelse,finfølelse,ærekrænkelse,ikrafttrædelse,fødselsforberedelse,beskadigelse,undsigelse,højnelse,fremskaffelse,gældseftergivelse,lokalbedøvelse,selvbebrejdelse,meningstilkendegivelse,imødegåelse,forsyndelse,fordummelse,gruppeledelse,forudanelse,skatteansættelse,nærdødsoplevelse,tilvejebringelse,raceadskillelse,knægtelse,ophøjelse,gendannelse,fuldtidsbeskæftigelse,legemliggørelse,kikkertundersøgelse,samlebetegnelse,forurettelse,selvudfoldelse,liveoptagelse,overførelse,fortørnelse,nedværdigelse,udpegelse,husundersøgelse,sædelighedsforbrydelse,sindsbevægelse,gallupundersøgelse,åremålsansættelse,tilskikkelse,nedgørelse,forfladigelse,besyngelse,bebudelse,forklarelse,fjernsynsudsendelse,skyggetilværelse,selvopofrelse,besvimelse,tilkendelse,idoldyrkelse,skattebegunstigelse,nærværelse,omskiftelse,resultatopgørelse,kontrolundersøgelse,udrejsetilladelse,hjernebetændelse,misfornøjelse,masseudryddelse,stemmeafgivelse,strøelse,levendegørelse,forfinelse,genansættelse,kransenedlæggelse,etageadskillelse,undvigelse,bedrøvelse,iværksætterydelse,tidsbesparelse,hævdelse,tidsangivelse,værdsættelse,kørselsgodtgørelse,udgangstilladelse,håndspålæggelse,selvagtelse,udfyldelse,overbygningsuddannelse,fuldendelse,djævleuddrivelse,formindskelse,nægtelse,påkaldelse,selvforherligelse,statsbegravelse,persondyrkelse,pinsebevægelse,langtidshukommelse,omskærelse,undergrundsbevægelse,tydeliggørelse,indtrædelse,åndsnærværelse,fravigelse,filmanmeldelse,brugeroplevelse,laboratorieundersøgelse,beredskabsstyrelse,tidsopfattelse,forulempelse,udtrædelse,genoplivelse,genindsættelse,fejlbedømmelse,dygtiggørelse,sexforbrydelse,mæthedsfornemmelse,driftsforstyrrelse,unddragelse,forsagelse,edsaflæggelse,erhvervsgrunduddannelse,hjemkaldelse,vandbakkelse,ransagelse,førelse,kongerøgelse,tingsliggørelse,idriftsættelse,aftrædelse,straffastsættelse,jordrystelse,befippelse,forjættelse,tronbestigelse,græmmelse,mødeindkaldelse,revselse,omstødelse,opbydelse,genovervejelse,afsigelse,forstavelse,øjenbetændelse,optugtelse,vildelse,sygehusindlæggelse,svangerskabsafbrydelse,undertegnelse,typegodkendelse,indgivelse,strafforfølgelse,fremsendelse,hakkelse,afholdsbevægelse,foruroligelse,indstiftelse,forforståelse,ørkendannelse,kraftudfoldelse,tvangsanbringelse,selvstændiggørelse,blotlæggelse,fremskyndelse,nedbrydelse,mindskelse,bihulebetændelse,engangsforeteelse,hjemtagelse,kunstforståelse,bibeholdelse,anråbelse,afsyngelse,ansigtsgenkendelse,bispevielse,behovstilfredsstillelse,retfærdighedsfølelse,gudsbespottelse,skriveøvelse,ordrebekræftelse,fuldførelse,bølgebevægelse,talstørrelse,indskrænkelse,anskueliggørelse,fortykkelse,ahaoplevelse,foregribelse,børnelammelse,cirkulæreskrivelse,indøvelse,selvantændelse,fastgørelse,kaldelse,voldgiftskendelse,udsigelse,forblindelse,indhentelse,forretningsførelse,omgørelse,forbigåelse,antændelse,legatbestyrelse,rundskrivelse,tjenestemandsansættelse,kulderystelse,selvundersøgelse,anstiftelse,kornstørrelse,jordpåkastelse,højtideligholdelse,hjernehindebetændelse,dyrebeskyttelse,ejerfornemmelse,fordærvelse,forvildelse,ungdomsydelse,luksustilværelse,leveringsbetingelse,dyppelse,knibeøvelse,omstyrtelse,genoplevelse,undgåelse,misopfattelse,forgudelse,selvbekræftelse,gældsstiftelse,merituddannelse,tilberedelse,menneskeliggørelse,pengeanbringelse,tillokkelse,indforståelse,jordfæstelse,opsættelse,forrykkelse,bespottelse,sprogtilegnelse,formildelse,nyttiggørelse,kundgørelse,selvfornægtelse,bilæggelse,nervebetændelse,moderskikkelse,fejlmeddelelse,underkuelse,verdsliggørelse,gendrivelse,pilotundersøgelse,værkfortegnelse,efterprøvelse,bodsøvelse,billiggørelse,ihukommelse,navlebeskuelse,tilmeldelse,forsmædelse,engangsydelse,berøvelse,afsværgelse,indarbejdelse,genfødelse,mangfoldiggørelse,genkaldelse,gravlæggelse,tilsigelse,svarskrivelse,idømmelse,legemsstørrelse,beskæmmelse,målbeskrivelse,helliggørelse,synsnedsættelse,æresfølelse,fredeliggørelse,skrivebordsafgørelse,lånoptagelse,anspændelse,vederkvægelse,ruelse,befæstelse,udsvævelse,slutopgørelse,genindkaldelse,umenneskeliggørelse,forgabelse,tilkaldelse,tomhedsfølelse,forsættelse,forhærdelse,forevigelse,indbringelse,uskadeliggørelse,fordrejelse,selvovervindelse,omverdensforståelse,uddybelse,fraværelse,fradømmelse,genopbyggelse,borgerliggørelse,fondsdannelse,foregivelse,opøvelse,affattelse,friholdelse,orddannelse,omskabelse,betryggelse,klorforbindelse,underbeskæftigelse,inderliggørelse,forstærkelse,affærdigelse,agterskrivelse,indoptagelse,begrædelse,besvigelse,oparbejdelse,slækkelse,berammelse,videresendelse,fagfællebedømmelse,følgeskrivelse,artsbestemmelse,hjemsøgelse,blokdannelse,samfølelse,efterstræbelse,løftelse,feltundersøgelse,begribelse,hjemgivelse,tidsbestemmelse,indeholdelse,mønsterbeskyttelse,opløftelse,tilbagetrædelse,behovsudsættelse,syndsbekendelse,fremtrædelse,principgodkendelse,stedsangivelse,klarlæggelse,præstevielse,undertvingelse,båndlæggelse,prydelse,smidiggørelse,ordforbindelse,allestedsnærværelse,afkræftelse,forfjamskelse,trolovelse,sommerforkølelse,ørebetændelse,opvækkelse,regnskabsførelse,højagtelse,selvfordybelse,soldyrkelse,opinionsdannelse,forflygtigelse,utilstrækkelighedsfølelse,indføjelse,nedtagelse,spægelse,anførelse,strafbestemmelse,afslappelse,klargørelse,vidnegodtgørelse,prisgivelse,genanskaffelse,fuldkommengørelse,overflødiggørelse,udbydelse,overvældelse,foretagelse,bortfjernelse,tilbageførelse,oversendelse,besmittelse,tugtelse,navngivelse,stedfæstelse,ædelse,lovfæstelse,fruestørrelse,salvelse,beklikkelse,omarbejdelse,forlokkelse,taktfølelse,forudbestemmelse,forhekselse,underforståelse,kropsbeherskelse,korrosionsbeskyttelse,afsvækkelse,husvalelse,udtømmelse,pandehulebetændelse,forskrivelse,overspringelse,planlæggelse,opdyrkelse,forarbejdelse,bedyrelse,vildførelse,forløbelse,fremsigelse,forhippelse,fyldestgørelse,ombringelse,hasteindlæggelse,forværrelse,iltforbindelse,undseelse,hjertekvababbelse,fraskrivelse,medtagelse,vederlæggelse,bogstavbetegnelse,hasteindkaldelse,opbringelse,typebestemmelse,vildledelse,henførelse,bemægtigelse,fingerøvelse,alenetilværelse,bønfaldelse,forstødelse,godtagelse,hjembringelse,bestyrkelse,bestridelse,retningsbestemmelse,åndsfraværelse,miskendelse,bønhørelse,middelstørrelse,forhåndsmeddelelse,beståelse,stedbestemmelse,bevidnelse,firmelse,helligelse,eftersendelse,strafforhøjelse,erlæggelse,anmasselse,naturalieydelse,besmykkelse,beklemmelse,dragelse,satsbetegnelse,frontdannelse,indfangelse,bøjningsendelse,ikraftsættelse,refleksbevægelse,molekylestørrelse,pantsættelse,tilsendelse,kæbehulebetændelse,genindtrædelse,initialforkortelse,tørrelse,forklejnelse,tildannelse,hidkaldelse,trickoptagelse,gravsættelse,fremdragelse,forøvelse,roddannelse,præpositionsforbindelse,bestigelse,behæftelse,heldagsbeskæftigelse,forlibelse,fremrykkelse,risstivelse,klientgørelse,forsnakkelse,åndeliggørelse,stileøvelse,ibrugtagelse,antegnelse,pro rata-hæftelse,forrettelse,gennemarbejdelse,fravælgelse,anrettelse,forstrækkelse,hjemførelse,aftvingelse,afførelse,ikendelse,indflettelse,beskærmelse,helligholdelse,hudflettelse,fortrædigelse,serieforbindelse,løsgørelse,afværgelse,vedgåelse,påkendelse,indvælgelse,tilendebringelse,udkæmpelse,bundfældelse,afvendelse,forgrimmelse,vanskeliggørelse,sideordningsforbindelse,blødgørelse,fremelskelse,ansvarsfralæggelse,overilelse,overflyttelse,forsværgelse,betvingelse,bortkastelse,aflokkelse,sænkelse,delagtiggørelse,blånelse,forløftelse,forstenelse,forstemmelse,forebringelse,kuldkastelse,afbeskikkelse,forlæggelse,seneskedebetændelse,sønderknuselse,efterladelse,forskubbelse,muliggørelse,synliggørelse,sprogfølelse,indvilgelse,annammelse,overbringelse,forskånelse,rygelse,talelidelse,slappelse,henlevelse,TV-udsendelse,forpustelse,vedtegnelse,a priori-antagelse,børne- og ungeydelse,fugtdannelse,undergivelse,upersonliggørelse,tilvendelse,ram-størrelse,lyksaliggørelse,findyrkelse,forbarmelse,eftertragtelse,VPN-forbindelse,oplivelse,underordningsforbindelse,besørgelse,erkyndigelse,afrettelse,tilbagevendelse,hærdelse,vedståelse,forgribelse,frameldelse,besnakkelse,skadesløsholdelse,forpestelse,åbenbarelse,cachehukommelse,udredelse,sammenholdelse,bekrigelse,fæstnelse,frilæggelse,guds velsignelse,voldførelse,træffeøvelse,de facto-anerkendelse,kropsliggørelse,overlistelse,gældsættelse,sysselsættelse,begrebsliggørelse,smidighedsøvelse,afmeldelse,interimledelse,frasigelse,rådførelse,frembydelse,vedføjelse,fuldstændiggørelse,ægtevielse,frisættelse,vanærelse,bivånelse,herliggørelse,deja-vu-oplevelse,ligbegængelse,tilkæmpelse,påtegnelse,forfattelse,efterabelse,forårsagelse,HD-uddannelse,omprøvelse,forædelse,vædelse,antastelse,videnskabeliggørelse,personliggørelse,udhævelse,guddommeliggørelse,skadedyrbekæmpelse,forvanskelse,forregnelse,modarbejdelse,fragåelse,undersættelse,undgældelse,kvægelse,italesættelse,tilstræbelse,bibringelse,sammenkaldelse,betuttelse,afkortelse,udspredelse,udståelse,forsødelse,VVM-redegørelse,afmattelse,påskyndelse,opkaldelse,forstuvelse,forkætrelse,ugifteydelse,sønderlemmelse,udlæggelse,tilstillelse,underskridelse,efterlignelse,gennemdrøftelse,iførelse,bestormelse,formastelse,ilandbringelse,trykstavelse,besværliggørelse,tilbagedannelse,understregelse,forblændelse,veddannelse,forkuelse,underordnelse,jævnførelse,vestliggørelse,pådømmelse,skadeopgørelse,forjagelse,teknonomuddannelse,opæggelse,vedlæggelse,undlivelse,rom-størrelse,indladelse,kasusendelse,forfægtelse,vandrebevægelse,undsættelse,udstyrelse,forivrelse,umuliggørelse,garantistillelse,gurudyrkelse,betrædelse,fetichdyrkelse,tilgængeliggørelse,fralæggelse,øjenforblindelse,forgrovelse,udråbelse,mestbegunstigelse,de jure-anerkendelse,sandsynliggørelse,fremholdelse,udødeliggørelse,genydelse,forurenelse,opfangelse,ud af kroppen-oplevelse,forledelse,gennemtvingelse,tropsøvelse,eftergørelse,indgydelse,viljesanspændelse,løskøbelse,fradragelse,strafeftergivelse,fuldbringelse,bejaelse,dånelse,pådragelse,ærefornærmelse	værelse,badeværelse,soveværelse,spøgelse,hotelværelse,klasseværelse,børneværelse,dobbeltværelse,venteværelse,lærerværelse,kollegieværelse,gæsteværelse,enkeltværelse,herreværelse,ragelse,pigeværelse,klubværelse,eneværelse,forværelse,kvistværelse,modtagelsesværelse,ungpigeværelse,anretterværelse,toiletværelse
4	tion	751	0.00307	751	0	situation,organisation,produktion,institution,information,tradition,generation,station,reaktion,nation,operation,opposition,position,ambition,aktion,funktion,inspiration,administration,demonstration,relation,præstation,revolution,kommunikation,kombination,redaktion,integration,sektion,reception,sanktion,kvalifikation,motion,dokumentation,korruption,obligation,inflation,direktion,frustration,konstruktion,konvention,auktion,daginstitution,instruktion,portion,reduktion,intention,spekulation,koncentration,definition,præsentation,innovation,variation,konfrontation,motivation,ekspedition,invitation,installation,fiktion,kompensation,koalition,civilisation,delegation,dispensation,illustration,resolution,argumentation,borgerrepræsentation,introduktion,statsobligation,destination,observation,prostitution,diskrimination,komposition,isolation,politistation,reparation,kollektion,fascination,infektion,attraktion,disposition,provokation,irritation,transaktion,tvangsauktion,distribution,repræsentation,sensation,restriktion,action,tankstation,interesseorganisation,donation,proportion,radiostation,kulmination,publikation,indikation,dekoration,licitation,intervention,manipulation,konsultation,ammunition,fraktion,desperation,konfirmation,association,lektion,option,hjælpeorganisation,komplikation,rekonstruktion,meditation,konstellation,evolution,bastion,foundation,vaccination,adoption,reformation,identifikation,aircondition,turistattraktion,manifestation,acceleration,arrestation,formation,intuition,korrektion,kaution,indignation,obduktion,børneinstitution,terroraktion,restauration,vibration,kondition,endestation,animation,paraplyorganisation,ventilation,perfektion,migration,stagnation,improvisation,rumstation,inspektion,centraladministration,autorisation,ekspropriation,transformation,prævention,flyvestation,landsorganisation,transplantation,interaktion,togstation,detention,deklaration,mutation,døgninstitution,føderation,telekommunikation,diskretion,destruktion,edition,applikation,abstraktion,reproduktion,førerposition,brandstation,kulturrevolution,koordination,kreation,immigration,reservation,menstruation,modifikation,navigation,audition,vegetation,visitation,rotation,renovation,inkarnation,genbrugsstation,varedeklaration,location,population,modreaktion,organdonation,konspiration,specifikation,deportation,magtdemonstration,solution,resignation,kapitulation,reinkarnation,forligsinstitution,nødsituation,racediskrimination,cirkulation,inskription,separation,masseproduktion,afskedsreception,konfiskation,misinformation,hallucination,dedikation,overproduktion,inkvisition,selektion,ovation,slowmotion,servicestation,implikation,projektion,benzinstation,kædereaktion,konversation,overreaktion,egenproduktion,legitimation,ration,maskinstation,jernbanestation,flådestation,veneration,friktion,klassifikation,diktion,deflation,ratifikation,agitation,kraftpræstation,injektion,amputation,konfektion,assimilation,ordination,rekreation,straffeaktion,promotion,dekonstruktion,jobrotation,kation,distraktion,stimulation,fabrikation,overrepræsentation,jurisdiktion,automation,inflammation,repetition,lokation,sterilisation,perception,diskvalifikation,udgangsposition,nøgleposition,imitation,kastration,proklamation,insemination,distinktion,konstitution,pragtpræstation,toppræstation,restitution,dissektion,kalkulation,serieproduktion,dagrenovation,infiltration,simulation,vejrstation,obstruktion,kønsdiskrimination,intonation,moddemonstration,eksamination,likvidation,dysfunktion,korrelation,forsøgsstation,erektion,insinuation,forsvarsposition,aldersdiskrimination,emigration,lotion,computeranimation,transition,reklamation,emotion,automatreaktion,genmanipulation,kognition,hyperinflation,figuration,konføderation,spedition,præmieobligation,kooperation,artikulation,translation,deputation,aspiration,negation,moderation,mediation,degeneration,fejldisposition,kollaboration,fortælletradition,konnotation,konfiguration,recitation,envejskommunikation,transformatorstation,bypassoperation,akkvisition,citation,instrumentation,samproduktion,protektion,prætention,paladsrevolution,reputation,emancipation,prækvalifikation,influenzavaccination,transskription,transformerstation,illumination,ægdonation,masturbation,penetration,induktion,okkupation,detonation,desinfektion,bodylotion,enkeltmandspræstation,solopræstation,bortadoption,kornproduktion,postekspedition,modulation,proposition,substitution,notation,billedlegitimation,fejlinformation,straffeekspedition,skyformation,svampeinfektion,notifikation,desinformation,magtbastion,invention,respiration,gestikulation,fluktuation,apparition,modtagestation,pladsreservation,destillation,billedmanipulation,rekommandation,translokation,kontemplation,trodsreaktion,deformation,fiskeriinspektion,addition,adaptation,konkretion,underrepræsentation,kontrarevolution,abdikation,lokalisation,ejakulation,kravspecifikation,determination,indiskretion,verifikation,personifikation,eskalation,kolonisation,koproduktion,præposition,rekvisition,radiumstation,oxidation,elimination,faktion,deklamation,manuduktion,mystifikation,regeneration,akkumulation,ekskommunikation,ægtransplantation,deduktion,absorption,kassation,gravitation,fanfiktion,suggestion,interpretation,akklamation,recirkulation,hovedreparation,stagflation,perforation,affektion,realisation,eruption,introspektion,reintegration,lavinflation,nødration,implantation,gratulation,segregation,kropsvisitation,multiplikation,sekretion,dagsration,inklination,eksekution,absolution,socialisation,ekstraktion,dagsproduktion,detektion,kontraktion,eksposition,korporation,vivisektion,oscillation,subskription,appropriation,tovejskommunikation,dissociation,centralstation,pollution,metafiktion,konjunktion,inhalation,individuation,intubation,modaktion,kompilation,modrevolution,børsspekulation,tvangssituation,xenotransplantation,participation,legation,obstipation,attestation,konsumption,immunreaktion,præfabrikation,kontraindikation,depravation,diversifikation,elevation,massesuggestion,konvektion,deceleration,divination,karantænestation,subtraktion,lodsstation,naturalisation,nomination,selvsuggestion,satisfaktion,petition,koagulation,desintegration,permutation,muskelinfiltration,deprivation,transposition,relæstation,samvariation,konjugation,krystallisation,brodernation,kopulation,alteration,dilatation,fragmentation,polarisation,reorganisation,immatrikulation,demotivation,falsifikation,kontamination,fanfiction,genmodifikation,subvention,transpiration,ekstrapolation,tyrestation,nonfirmation,konception,differentiation,krydsreaktion,allitteration,obstruction,rehabilitation,præparation,luksation,jordspekulation,koppevaccination,kapitalakkumulation,defækation,bagprojektion,kremation,retention,novation,affektation,reeksamination,assertion,anticipation,mortifikation,antikonception,lamentation,håndlotion,annullation,initiation,deviation,fertilisation,kvindeemancipation,indoperation,massefabrikation,radiation,alimentation,aberration,eksploration,forhåndsreservation,approksimation,inhibition,stratifikation,brintion,prædiktion,translitteration,grundspekulation,emanation,duplikation,eksemplifikation,vokalisation,triangulation,transsubstantiation,materialisation,eksaltation,neutralisation,interjektion,proskription,revaccination,rekapitulation,sedimentation,kodifikation,ekstinktion,inokulation,eksponentialfunktion,standbyfunktion,deklination,kongregation,glaciation,prædestination,refraktion,folkerepræsentation,adsorption,calmettevaccination,kondensation,pulsation,strangulation,bortoperation,subordination,fibrillation,fortifikation,annotation,kollokation,amortisation,katekisation,lotterikollektion,komparation,diffraktion,defloration,sublimation,alienation,underproduktion,desertion,designation,subsumption,trepanation,polymerisation,fermentation,affirmation,resorption,approbation,konsternation,allokation,attribution,konsignation,fundation,demarkation,amplitudemodulation,karnation,accentuation,mumifikation,broderorganisation,demobilisation,kanalisation,inkorporation,versifikation,selvisolation,klippe-klistre-funktion,desertation,postposition,inkassation,gyration,ovulation,demodulation,taksation,repartition,emendation,decentralisation,kollation,bidragsresolution,eksplikation,konstriktion,denotation,apposition,snoozefunktion,hyperkorrektion,afinstallation,kondemnation,frekvensmodulation,kanonisation,derivation,defibrillation,interpolation,specialprævention,justifikation,perseveration,præsupposition,perturbation,habituation,gradation,glorifikation,gemination,vidimation,demoralisation,absentation,okulation,indisposition,ondulation,generalisation,sideordningskonjunktion,retardation,science fiction,kontinuation,win-win-situation,kumulation,immobilisation,understimulation,incitation,simplifikation,fabulation,granulation,relaksation,totalsituation,amalgamation,evaporation,S-station,remonstration,flagellation,alternation,insideinformation,graduation,denuntiation,rekompensation,konstipation,legalisation,typifikation,reduplikation,profanation,depilation,interpunktion,disjunktion,rektifikation,laktation,overstimulation,intimidation,stipulation,usurpation,gratifikation,godsekspedition,insubordination,VVS-installation,punktaktion,vindikation,kontribution,disproportion,idéassociation,vind-vind-situation,eksspiration,dekomposition,public relation,depersonalisation,transfiguration,kommutation,prolongation,deeskalation,deskription,afreaktion,akkommodation,agglutination,ionisation,desorganisation,interpellation,derealisation,ekspatriation,akklimatisation,udkrystallisation,konsekration,rektion,retrospektion,kongestion,aggravation,prænumeration,relegation,reifikation,dekoncentration,seriefabrikation,testation,slumrefunktion,rejektion,flotation,inkamination,bz-demonstration	
4	ring	1775	0.00298	1752	23	regering,erfaring,udfordring,forklaring,investering,ændring,vurdering,turnering,placering,bekymring,forandring,forbedring,opfordring,forsikring,erindring,finansiering,begejstring,scoring,erklæring,etablering,markedsføring,nedskæring,fyring,renovering,høring,styring,afsløring,globalisering,føring,indvandring,prioritering,regulering,håndtering,afhøring,formulering,rengøring,opsparing,skildring,evaluering,klimaforandring,orientering,registrering,forvirring,levering,forhindring,læring,afklaring,modernisering,privatisering,hindring,aflevering,servering,næring,vandring,aktivering,lancering,filmatisering,udlicitering,sikring,familiesammenføring,justering,pensionering,liberalisering,pensionsopsparing,markering,effektivisering,fernisering,bedring,børsnotering,opklaring,parkering,gruppering,opdatering,rekruttering,færing,tatovering,udlevering,nedjustering,beundring,klimaændring,pokalturnering,organisering,digitalisering,berøring,restaurering,fejring,åbenbaring,omstrukturering,nominering,ernæring,opbevaring,sygesikring,kåring,ytring,isolering,forundring,erobring,implementering,eksponering,konstatering,koordinering,radikalisering,indlæring,boring,forankring,beskæring,omskæring,konsolidering,fokusering,afføring,internationalisering,rationalisering,opjustering,topplacering,kvittering,annoncering,opmuntring,hensigtserklæring,fordring,halvering,centralisering,opgradering,belejring,harmonisering,skæring,industrialisering,demokratisering,afspærring,normering,devaluering,ombæring,fotografering,likvidering,rehabilitering,udstationering,opblomstring,forværring,koalitionsregering,indføring,involvering,evakuering,sparring,realisering,rivalisering,affjedring,udskæring,polarisering,linjeføring,blomstring,indkvartering,projektering,decentralisering,præcisering,notering,konvertering,risikovurdering,udvandring,overlevering,livsforsikring,lagring,samlingsregering,kærlighedserklæring,rejseforsikring,oplæring,montering,stemmeføring,begæring,reducering,normalisering,frasering,stabilisering,specialisering,sortering,vidneforklaring,livserfaring,blokering,certificering,mobilisering,redigering,bogføring,kreditvurdering,folkevandring,bevaring,kopiering,konstituering,optimering,konkursbegæring,plyndring,opkvalificering,revalidering,profilering,bortforklaring,sanering,ørkenvandring,kapring,islamisering,falliterklæring,lægeerklæring,legalisering,indespærring,programmering,generalisering,forvaring,kursændring,servostyring,rapportering,krigserklæring,dramatisering,vejspærring,aldring,gældssanering,topstyring,kommercialisering,instrumentering,boligsikring,kvalitetssikring,patruljering,medicinering,kolonisering,gearing,marginalisering,kriminalisering,programerklæring,kystsikring,datering,nationalisering,navneforandring,afbureaukratisering,foræring,individualisering,dosering,patientforsikring,stigmatisering,boksering,underernæring,aflejring,sondering,piratkopiering,automatisering,kloakering,akkreditering,sondring,revurdering,motivering,deponering,skumring,nedprioritering,fodring,professionalisering,annektering,spærring,affyring,ansvarsforsikring,tæring,gardering,visualisering,ofring,bilforsikring,degradering,diskriminering,udbedring,forbrødring,politisering,eskalering,gæring,omprioritering,belæring,catering,ulykkesforsikring,urbanisering,brandforsikring,krisestyring,relancering,diagnosticering,lindring,punktering,indboforsikring,omrøring,dæmonisering,favorisering,afspadsering,parring,standardisering,promovering,polstring,reorganisering,barbering,elektrificering,kryptering,befordring,vielsesring,sekularisering,differentiering,fejlvurdering,tørring,indoktrinering,detailstyring,risikostyring,publicering,bundplacering,omorganisering,stimulering,hovedrengøring,omrokering,søforklaring,klargøring,radering,konservering,kønskvotering,indsnævring,opsummering,klatring,fiksering,annullering,servicering,rangering,fejlaflevering,flertalsregering,votering,navneændring,børneopsparing,nedvurdering,legitimering,socialisering,udtørring,deregulering,opprioritering,eksilregering,personificering,nuancering,omklamring,ratificering,formering,vidneafhøring,restrukturering,revidering,underminering,efterrationalisering,afskedsbegæring,lysregulering,undervisningsdifferentiering,jernbaneoverskæring,klassificering,opsporing,resocialisering,centring,afrapportering,suspendering,fundering,skadeforsikring,genetablering,returnering,fortæring,rationering,affaldshåndtering,legering,oplagring,afsporing,intimidering,smertelindring,overskæring,lakering,nøglering,amerikanisering,fremtidssikring,undervurdering,perspektivering,indlevering,kategorisering,maskering,udeservering,refinansiering,internering,eksekvering,positionering,simulering,disponering,indkøring,møblering,brandsikring,åring,nedgradering,rokering,installering,krydring,selvpromovering,krisehåndtering,kaskoforsikring,generobring,samkøring,personskildring,partshøring,versionering,dehydrering,integrering,bugsering,dimensionering,selvovervurdering,celleforandring,omkalfatring,ajourføring,statusopdatering,fakturering,flykapring,afvandring,modellering,intensivering,lokalisering,repatriering,sædeskildring,fingerring,honorering,ghettoisering,præmiering,visitering,patentering,jernring,kvalitetsstyring,uddelegering,fragmentering,mundering,eliminering,filtrering,destabilisering,forlovelsesring,årring,tyverisikring,bureaukratisering,disciplinering,hamstring,uniformering,udplyndring,clearing,efterisolering,mistillidserklæring,signalforvirring,vægring,smøring,skriveblokering,orkestrering,afmontering,omplacering,førtidspensionering,graduering,sporing,forsuring,kanonisering,midterplacering,revitalisering,indstudering,seksualisering,reformering,konkretisering,tivolisering,spisevægring,tilsløring,forsnævring,diamantring,afregulering,kvalificering,kremering,fermentering,dyrtidsregulering,rekognoscering,europæisering,ommøblering,tangering,supplering,overvurdering,retsbelæring,panorering,mønstring,vejføring,gennemtæring,identificering,afkriminalisering,synkronisering,institutionalisering,reetablering,romantisering,aptering,mekanisering,indregistrering,afbalancering,frasortering,strukturering,idealisering,panering,nyvurdering,arkivering,kameraføring,glorificering,halsudskæring,finjustering,stilisering,akademisering,sprogforbistring,helgardering,imprægnering,kønsbehåring,falstring,lønregulering,problematisering,afbestillingsforsikring,lånefinansiering,sammenføring,opmagasinering,spiring,kompostering,ekspropriering,sløring,jonglering,overmedicinering,afskæring,karakterisering,detailprojektering,indplacering,drapering,kæntring,armering,polering,kapitalisering,væring,opnormering,alarmering,begrebsforvirring,fjernstyring,regnskabsføring,overdosering,opskæring,cementering,overvintring,rørføring,desorientering,forcering,negligering,budgettering,partering,produktplacering,demontering,overføring,portrættering,kommatering,stationering,adfærdsregulering,kropsvisitering,omvurdering,tilskæring,kvotering,kønsdiskriminering,kurssikring,afkolonisering,revaluering,pirring,moralisering,kontraktstyring,forsiring,pointering,manipulering,kollektivisering,bagatellisering,postering,fusionering,minimering,hulahopring,asfaltering,regionalisering,monopolisering,assimilering,understyring,detaljering,motorisering,forskudsregistrering,plagiering,konfiskering,afblomstring,overfakturering,systematisering,djøfisering,formalisering,badering,tematisering,raffinering,kursivering,rundbarbering,sterilisering,inkorporering,forvitring,affotografering,indgravering,gentrificering,behåring,sponsering,popularisering,tabuisering,overstyring,tandregulering,skattefinansiering,anonymisering,kalibrering,stilforvirring,grødeskæring,validering,flydespærring,tilbageføring,komprimering,kultivering,dekantering,subsidiering,indeksering,pornoficering,strukturrationalisering,nedgøring,fabulering,homogenisering,æstetisering,nivellering,genopblomstring,mytologisering,tvangsfodring,segregering,reklamering,marmorering,allokering,reservering,sublimering,emballering,udradering,omgruppering,hulmursisolering,nummerering,idyllisering,manøvrering,aktualisering,indlogering,grovsortering,retardering,røgring,gravering,markvandring,aftørring,segmentering,parallelparkering,ornamentering,infiltrering,penselføring,relativering,desertering,kommentering,brutalisering,feminisering,kommunalisering,fejlplacering,omformulering,skamfering,overeksponering,banalisering,pansring,pervertering,afsondring,påføring,herreekvipering,forspiring,effektuering,ringeagtsytring,krakelering,kastrering,marionetregering,dehumanisering,kulfyring,pilotering,navigering,inkludering,tilvandring,ekskludering,instrumentalisering,opformering,desavouering,distancering,fremføring,lygteføring,censurering,perforering,klaring,skravering,skråparkering,neutralisering,dissekering,fraternisering,journalisering,sekventering,akkumulering,katalogisering,processtyring,afpolitisering,factoring,transformering,børnesikring,arbejdsvægring,opfostring,overhøring,makulering,modificering,nednormering,barndomserindring,staffering,degenerering,ignorering,simplificering,tøndring,sjælevandring,erodering,inseminering,ordinering,accentuering,kreditering,balkanisering,sanktionering,samtidsorientering,treåring,galvanisering,vandføring,dobbelteksponering,atomisering,kannibalisering,frankering,pausering,servietring,demaskering,balancering,traumatisering,selvmedicinering,domesticering,pigmentering,miskreditering,invalidering,psykologisering,proviantering,intellektualisering,omdefinering,fejldisponering,proletarisering,overdramatisering,billettering,afmagring,maksimering,deportering,kanalisering,signering,trivialisering,destillering,patinering,ansporing,overfodring,børneparkering,glasering,decimering,maltraktering,balsamering,materialisering,marinering,associering,kostumering,ideologisering,refundering,pligtaflevering,korrumpering,cupturnering,afmytologisering,servereturnering,tapetsering,melodiføring,udspionering,anfordring,verificering,gruppelivsforsikring,amputering,vandalisering,foring,facilitering,citering,rundering,generering,førstegangsaflevering,forbistring,nazificering,distribuering,diversificering,delegering,retouchering,reinvestering,teoretisering,ritualisering,eftersynkronisering,kæltring,afluring,bidering,teknologisering,fiktionalisering,alfabetisering,indlejring,rubricering,lejring,omregistrering,opfodring,nedsparing,plombering,klausulering,kvantificering,signalering,omdirigering,demoralisering,demilitarisering,kildesortering,oxidering,ørenring,forplumring,detronisering,strangulering,dekorering,dæmring,terrorisering,humanisering,civilisering,celebrering,beluring,tankeoverføring,hønsering,skyggeregering,flambering,økonomisering,centrifugering,garnering,skitsering,grundforbedring,kondensering,desillusionering,aldersdiskriminering,intimbarbering,gering,inhalering,kontaminering,underbudgettering,akklimatisering,konsumering,amortisering,sejlføring,toåring,omprogrammering,afmystificering,becifring,pasteurisering,deployering,dybdeboring,smitteopsporing,kupering,kurtisering,gratinering,indskæring,deformering,ompostering,affodring,pendulering,taksering,demobilisering,restituering,opskalering,rentesikring,ciselering,pacificering,diskvalificering,korttidsparkering,målformulering,initiering,dublering,postkvittering,indsmøring,finlandisering,smadring,udsondring,fotokopiering,vaccinering,defibrillering,afmilitarisering,regenerering,gennemføring,heroisering,kabelføring,genmodificering,soignering,seponering,separering,vitalisering,sikkerhedskopiering,vulgarisering,faring,underføring,russificering,schattering,føderalisering,reaktivering,korrigering,bæring,passivisering,voltigering,eksemplificering,afindustrialisering,motorring,kontering,rasering,dechifrering,telefonering,signetring,mumificering,adressering,afpatruljering,undring,braisering,ekvipering,heksering,operationalisering,desinficering,deklassering,lutring,genvurdering,hospitalisering,præparering,bogstavering,blødgøring,afnazificering,torpedering,vansiring,lavering,selvpensionering,saldokvittering,lagerføring,skalering,manifestering,skibsproviantering,kassering,definering,periodisering,krystallisering,inficering,fireåring,diskontering,opvurdering,udkrystallisering,firepartiregering,absorbering,modulering,fouragering,parafrasering,parallelisering,kalkering,frysetørring,objektivisering,taktregulering,nedskalering,campering,relativisering,brugerfinansiering,processering,temperering,deaktivering,strandfodring,langtidsopbevaring,proportionering,koncentrering,skandalisering,frostsikring,hyring,minering,kompromittering,surring,bemestring,påsmøring,redefinering,potensering,patronisering,brøndboring,specificering,sindsforvirring,indtørring,hierarkisering,ventilering,etikettering,fraktionering,vagabondering,blanchering,laminering,tilbagedatering,afsyring,arrangering,reevaluering,underprioritering,magnetisering,internalisering,objektivering,oliefyring,idolisering,bosondring,kondemnering,projicering,forkludring,filetering,månevandring,naturalisering,centrering,estimering,duplikering,formatering,tidsstyring,stopfodring,chartring,materialehåndtering,pulverisering,destruering,deklarering,illuminering,oplagsnæring,perfektionering,symbolisering,føntørring,intonering,selektering,rateforsikring,meritering,spidsformulering,abdicering,triangulering,sensibilisering,grønlandisering,sektionering,indrullering,dossering,frisering,vulkanisering,afdramatisering,plissering,afmønstring,stagnering,indsnøring,titulering,kodificering,tyveriforsikring,gennemskæring,immunisering,autoklavering,motionering,germanisering,snævring,advisering,trepanering,udboring,skandering,auditering,erotisering,transmittering,teknokratisering,gruppeforsikring,trykimprægnering,gardinring,immobilisering,informering,eksilering,analysering,monitering,alliancering,gennemboring,forgæring,kalkulering,afnationalisering,udforing,opmarchering,fritering,recirkulering,inaktivering,tranchering,genmanipulering,verbalisering,rekonstruering,overstimulering,transponering,indmuring,rekvirering,træskæring,matrikulering,indbrudssikring,aktivisering,kompensering,animering,aftabuisering,indkassering,sprogføring,diktering,rådføring,besvangring,stratificering,dirigering,botanisering,aflæring,luftkonditionering,kraftoverføring,eftersporing,subjektivering,autorisering,topnotering,majorisering,dokumentering,foliering,konceptualisering,glasforsikring,udmanøvrering,solidarisering,kontrahering,udspecificering,karburering,formynderregering,valorisering,salutering,ompolstring,termografering,afideologisering,apportering,fertilisering,udmatrikulering,transskribering,kolportering,tyrannisering,gelering,optørring,kokkerering,skarring,racediskriminering,eksplicitering,kuvertering,studering,afsikring,barrikadering,underfrankering,bladring,administrering,gæsteparkering,planering,autolakering,profanering,deflorering,ådring,smukkesering,påmønstring,overfrankering,falsificering,konditionering,romanisering,maskulinisering,oliering,udrangering,stiføring,misinformering,eutrofiering,gummiering,kloring,alkoholisering,forhyring,akkordering,tilføring,afsnøring,sekvensering,kontrastering,snøring,detektering,gasfyring,debitering,bandagering,korsettering,afliring,guillotinering,depravering,koagulering,splintring,polymerisering,komplettering,udtværing,prækvalificering,besejring,løsøreforsikring,bunkring,tillæring,ekstrapolering,ionisering,underforsikring,fremdatering,divisionalisering,avertering,grundering,sammentømring,dematerialisering,farsering,entring,eskortering,illustrering,mikroskopering,kolorering,parfumering,kystfodring,computerisering,titrering,observering,totalsanering,lasering,udhungring,deltagerstyring,omadressering,uddifferentiering,nedfotografering,udkonkurrering,negering,historisering,udbasunering,indfyring,minimumnormering,teknificering,partsforklaring,hulrumsisolering,tunnelering,undergæring,musealisering,beordring,sautering,fastgøring,omlejring,gradering,travestering,smuldring,indrangering,udsortering,indikering,afrikanisering,pixelering,licensering,insolvenserklæring,petring,udstyring,bombardering,detonering,sedimentering,reflektering,materialevandring,fabrikering,brodering,primitivisering,opreklamering,inspicering,glamourisering,typificering,kreering,filosofering,skelettering,bortrationalisering,ensilering,smeltesikring,lamentering,ruinering,prospektering,skalpering,frekventering,anodisering,parodiering,adoptering,oppolering,pudring,musikalisering,danisering,visering,ankring,statuering,muring,filering,overgæring,parering,deeskalering,pausekommatering,sprøjtelakering,spolering,denaturering,vibrering,firing,licitering,strømkæntring,generindring,camouflering,samlokalisering,opankring,ækvivalering,demineralisering,tarifering,poetisering,karikering,viderebefordring,engagering,taljering,komponering,præservering,giftering,overdimensionering,udsparing,pulsering,telegrafering,besværing,inddatering,relatering,amalgamering,containerisering,typografering,dominering,underfakturering,agglutinering,signalisering,depreciering,deodorisering,diskreditering,spatiering,dissentiering,deklamering,gelatinering,podsolering,paradering,gagering,søndring,euforisering,homologisering,driftssikring,latinisering,klimatisering,kantonnering,fostring,plumring,defilering,udmønstring,remplacering,geminering,fremturing,flankering,grimassering,klovbeskæring,evaporering,udtæring,fetering,formskæring,meritoverføring,substituering,bivuakering,palletering,banderolering,cirkulering,vegetering,eskamotering,leksikalisering,vikariering,eksploitering,remittering,garrottering,tjæring,rumstering,lægtring,relegering,virilisering,konstruering,aktionering,autonomisering,litrering,indklamring,traversering,sukring,sekundering,frustrering,mortificering,passering,polemisering,tøjring,giring,låring,slingring,granulering,sintring,paraffinering,tuschering,hamring,skraffering,distrahering,overklistring,kryptografering,palpering,dupering,designering,gennemsyring,terrassering,protokollering,bonitering,indemuring,alternering,irisering,godtkøbsforklaring,tilkøring,stipulering,taktering,syntetisering,dags dato-kvittering,tracering,udplacering,derivering,egalisering,e-læring,kartering,borteliminering,udhamring,triumfering,bronzering,solitærring,dukkeføring,appretering,synkretisering,facettering,kumulering,tilgitring,barbarisering,vidimering,dispergering,okkupering,klarificering,invertering,ekspatriering,kalfatring,tjenestegøring,vindicering,interpellering,interimskvittering,fluktuering,forkætring,trangsvurdering,epilering,kannelering,indsukring,chifrering,undereksponering,dag til dag-levering,paspolering,subventionering,adsorbering,indfiltring,arkaisering,-åring,instruering,typisering,stencilering,foruddiskontering,paralysering,kommittering,konferering,antikisering,kandisering,korrugering,teksturering,figurering,attakering,konfektionering,anglisering,versificering,hypostasering,dryptørring,græcisering,svabring,kautionering,synkopering,transistorisering,radiodirigering,allegorisering,plakatering,approbering,mercerisering,magasinering,interimsregering,addering,udsyring,konfundering,immatrikulering,molestering,konvolutering,garnisonering,kalligrafering,misrekommandering,interpolering,antedatering,instituering,galopering,rejicering,trassering,varmgalvanisering,panelering,udkåring,purering,grillering,harpunering,brunering,postdatering,forhåndsreservering,emaljering,trafikering,inventering,prolongering,indkalkulering,attestering,indslumring,konturering,p-ring,abandonnering,underdimensionering,sjakring,deplacering,emulgering,avancering,demolering,desarmering,afregistrering,enåring,dementering,parlamentering,detachering,frottering,harcelering,shamponering,maskinisering,deklinering,kollationering,afinstallering,ekstemporering,dimittering,oversomring,hypnotisering,touchering,ondulering,vokalisering,udstaffering,aktering,televisering,ekspedering,longering,metallisering,skuring,overgearing,udparcellering,kompilering,konformering,renskæring,pelletering,indregulering,ramponering,vattering,parafering,chaptalisering,trænering,efterdatering,evolering,intubering,diftongering,schedulering,understimulering,obducering,tabulering,depersonalisering,monoftongering,permittering,aggravering,excerpering,annotering,færdiggøring,reversering,overpolstring,rektificering,overforsikring,overkogssikring,ovntørring,flammeskæring,rekapitulering,analogisering,prekarisering,postindkassering,kvadrering,biografering,plettering,fingerering,afreagering,eftergøring,kontrasignering,kloroformering,nasalering,participering,udrøring,emancipering,fosforescering,konfirmering,fundamentering,aggregering,tro og love-erklæring,pubesbehåring,afmagnetisering,vitaminisering,tarering,bestialisering,pokulering,henføring,lædering,konfrontering,afpersonalisering,udføring,traktering,datamatisering,indklarering,forpurring,lystring,familiarisering,toupering,dekupering,paginering,desorganisering,klorering,bortvandring,klarering,V-udskæring,disengagering,afparering,haglskadeforsikring,saldering,fremprovokering,denationalisering,udmagring,plastificering,reificering,kachering,inokulering,O-ring,emigrering,litografering,pomadisering,kapunering,teleskopaffjedring,gennemkomponering,improvisering,trunkering,stenografering,bardering,løsgøring,desinformering,vindaflejring,afprivatisering,funktionalisering,subsumering,klavring,transpirering,demarkering,firepartsregering,refusering,højisolering,HFI-sikring,duellering,udsanering,demonstrering,bortadoptering,duplicering,datastyring,karbonisering,dollering,satirisering,kanonering,bortoperering,deviering,transferering,optering,hydrering,referering,røring,palatalisering,applicering,rikochettering,sufflering,tabellering,summering,skalmuring,resumering,substantivering,konvojering,inkriminering,abonnering,gravitering,labialisering,oversmøring,suffigering,attachering,atrofiering,dogmatisering,transplantering,dressering,liering,endossering,katekisering,abstrahering,testamentering,transportering,indkopiering,protegering,krokering,kommutering,linjering,ovnlakering,finering,hospitering,okulering,supervisering,damascering,initialisering,passivering,gitring,transitering,decentrering,udpolstring,kujonering,absentering,udbæring,editering,platinering,dragering,formtørring,påhøring,redressering,prognosticering,emulering,mattering,aromatisering,paragrafering,nedføring,girering,fluidisering,klandring,mouillering,affordring,subtrahering,basering,kombinering,tamponering,skematisering,indicering	spring,forspring,udspring,sidespring,krumspring,kvantespring,tigerspring,længdespring,højdespring,stangspring,faldskærmsudspring,trespring,fremspring,elastikspring,kraftspring,hovedspring,opspring,badutspring,løvspring,trampolinspring,dødsspring,nedspring,flyvespring
4	ling	575	0.00217	575	0	udvikling,stilling,behandling,udstilling,afdeling,forhandling,forestilling,handling,fortælling,samling,generalforsamling,anbefaling,meningsmåling,betaling,indstilling,måling,problemstilling,ligestilling,fremstilling,fordeling,bevilling,kylling,forsamling,udbetaling,afhandling,opstilling,indsamling,cykling,afvikling,sagsbehandling,maling,formidling,tvilling,omstilling,digtsamling,brugerbetaling,bestilling,udveksling,deling,forvandling,uddeling,lærling,fordobling,opdeling,udstråling,fængsling,startopstilling,særudstilling,forskelsbehandling,indbetaling,forveksling,kobling,mishandling,tildeling,stråling,musling,optælling,arbejdsformidling,produktudvikling,tilbagebetaling,tackling,forenkling,særbehandling,terrorhandling,overhaling,novellesamling,byudvikling,omfordeling,skilling,prisudvikling,videreudvikling,henstilling,ælling,bowling,tælling,strålebehandling,killing,yngling,lønforhandling,nationalforsamling,opsejling,kælling,trepartsforhandling,indskoling,føling,kamphandling,riesling,forvikling,opsamling,krigshandling,yndling,nedtælling,lederstilling,opkomling,blåstempling,indsmugling,førstebehandling,egenbetaling,fuldtidsstilling,afveksling,strafudmåling,genforhandling,menneskesmugling,spejling,mægling,fødeafdeling,brevveksling,doktorafhandling,valghandling,vrangforestilling,voldshandling,intensivafdeling,afkøling,dribling,holdopstilling,kuling,særling,opmåling,kammusling,curling,smugling,folketingssamling,tredobling,kønsfordeling,knipling,skudveksling,forædling,nyhedsformidling,indsejling,befaling,sperling,inddeling,healing,efterbehandling,ligebehandling,udhuling,stikling,omskoling,ordveksling,schilling,sammenstilling,nedkøling,ræling,særstilling,genfortælling,sammenkobling,folketælling,afspejling,overbetaling,bogsamling,trilling,tredeling,topstilling,pejling,landevejscykling,varsling,dobling,blåmusling,gambling,hormonbehandling,fintælling,omdeling,udskoling,vinkling,kørestilling,overfladebehandling,skoling,pærevælling,opkobling,kattekilling,afbetaling,kulturformidling,bådudstilling,grævling,selvudvikling,isolationsfængsling,efterbetaling,videndeling,køling,fejlbehandling,tekstbehandling,andenbehandling,styling,indføling,smertebehandling,bestråling,domsforhandling,cirkusforestilling,sampling,bestalling,pendling,rolling,voksenlærling,modstilling,tidsbestilling,børnemishandling,pladesamling,idéudvikling,heling,vandreudstilling,tredjebehandling,pusling,overspringshandling,soling,festforestilling,rammefortælling,sterling,forudbestilling,forudbetaling,bodeling,symptombehandling,gamling,wrestling,niveaudeling,stempling,spraymaling,byrdefordeling,overskudsdeling,sagsfremstilling,databehandling,udmåling,krøbling,slagtekylling,bemaling,underbetaling,forsimpling,deltidsstilling,efterbevilling,tumling,fårekylling,oliemaling,afkobling,celledeling,realitetsforhandling,optrevling,saling,kombinationsbehandling,varmebehandling,forhaling,frimærkesamling,grønskolling,stænderforsamling,svækling,forsegling,sammentælling,baggrundsstråling,krigsmaling,tvangsbehandling,blodansamling,fosterstilling,porcelænsmaling,vælling,alkoholbevilling,gallaforestilling,mandsling,pensling,selvfremstilling,ordstilling,nedsabling,påsejling,omtælling,laserbehandling,femdobling,kønsopdeling,skrædderstilling,støjmåling,hjertemusling,pebling,shilling,brisling,luftspejling,akrylmaling,møntsamling,firling,mindeudstilling,rodbehandling,ansamling,mangedobling,tilkobling,skævdeling,spareskilling,tidobling,afbestilling,indkapsling,harekilling,sidestilling,hanekylling,befamling,valgstedsmåling,overmaling,veksling,genspejling,mobilbetaling,retshandling,dåbshandling,førerstilling,besejling,egnsudvikling,rammebevilling,ætling,gæsling,genopstilling,brevsamling,hvilling,besjæling,væskeansamling,lagdeling,udpensling,fritstilling,gennemsejling,klatskilling,nulstilling,prædikensamling,overrisling,peeling,selvspejling,halvtidsstilling,hækling,forbehandling,dialysebehandling,forfordeling,gammastråling,toldbehandling,indtaling,timebetaling,gnalling,tjenestemandsstilling,hastebehandling,plenarforsamling,murerlærling,firdobling,eftertackling,orddeling,revling,knivmusling,udsejling,rustbehandling,venteafdeling,todeling,lotusstilling,adling,takling,landmåling,stalling,forskalling,researchafdeling,udkobling,usling,legetøjsafdeling,omveksling,seksdobling,rafling,rejekælling,chokbehandling,udsmugling,livsstilling,realitetsbehandling,modfortælling,tvedeling,vikling,kuldsejling,indstråling,normalfordeling,spuling,pladsbestilling,formæling,frakobling,ligedeling,overrumpling,heltidsstilling,beføling,talehandling,iling,kølhaling,kutling,materialesamling,rappelling,quisling,nøglestilling,dagsbefaling,færdigbehandling,skrælling,malerlærling,talbehandling,forkrøbling,flerdobling,filmforestilling,alkydmaling,formuefordeling,midterstilling,indvarsling,giroindbetaling,blåhvilling,jordstråling,tredjeinstansbevilling,skrabekylling,fødselsafdeling,formaling,afsvaling,femling,indvikling,besegling,karrierestilling,ordudveksling,tilbagekobling,skiftesamling,sproghandling,gennemtrawling,afhøvling,redobling,stabling,dyndsmerling,udmaling,formelsamling,dobbeltstilling,fasankylling,besudling,findeling,gennemhegling,opstabling,underafkøling,bevikling,kobberstiksamling,tidsindstilling,tjenestebefaling,avling,alfastråling,grundskoling,myndling,topartsforhandling,underopdeling,spartling,indhandling,sladderkælling,udbuling,tiljubling,præferencestilling,ludbehandling,håndværkerlærling,seriefremstilling,fornikling,forsåling,udbyttedeling,værling,sandmusling,forvarsling,underinddeling,døgling,punktopstilling,afsvovling,natostilling,betastråling,skiftebehandling,binomialfordeling,modforestilling,sprøjtemaling,korridorforhandling,opskoling,hemmeligstempling,indkobling,finindstilling,gurgling,opgejling,drikkeskilling,fristilling,smerling,perlemusling,omsadling,afskalling,prikling,svovling,udspiling,epoxymaling,afmåling,filing,påmaling,fuldspartling,tilfiling,tandoorikylling,boremusling,fejltælling,kokkelærling,neddrosling,dammusling,opvigling,formøbling,public relation-afdeling,indhylling,tidsstempling,serumbehandling,trokling,skovling,salpetersyrling,tilsjofling,konsonantfordobling,pilling,nagling,drøvling,foling,hønekylling,krækling,drosling,aftakling,tapsamling,dybdemåling,punsling,lobhudling,afpæling,kalkunkylling,foregøgling,hakkekylling,toskilling,underkøling,antirefleksbehandling,fordunkling,høvling,keling,ledstilling,hængsling,rifling,sammenstimling,mejsling,strigling,omhylling,gaussfordeling,grundstofforvandling,leddeling,gennemprygling,tønderknipling,trykkerlærling,forkvakling,svovlsyrling,overstempling,ægstilling,topforhandling,skråstilling,sadling,segmentopdeling,afvarsling,indhuling,tromling,trindeling,vandsamling,underhandling,snorkling,forindstilling,mergling,jodbehandling,flerpartsforhandling,udmejsling,vævling,elskling,sprinkling,spoling,kapsling,halvdagsstilling,hegling,trawling,indstempling,opspiling,grendeling,nedhaling,tidsdeling,antistatbehandling,afhjemling,dybkøling,pælemusling,udstempling,HR-afdeling,tilmåling,gradmåling,prygling,uv-stråling,sjofling,onlinebehandling	
4	ghed	242	0.00206	242	0	mulighed,virkelighed,lejlighed,myndighed,kærlighed,omstændighed,offentlighed,rettighed,rådighed,menneskerettighed,enighed,hemmelighed,lighed,personlighed,ledighed,sandsynlighed,tryghed,uenighed,hastighed,samvittighed,anklagemyndighed,vanskelighed,nødvendighed,ulighed,svaghed,tålmodighed,retfærdighed,urolighed,menighed,tilfældighed,almindelighed,uafhængighed,faglighed,færdighed,værdighed,afhængighed,varighed,vittighed,ejerlejlighed,forskellighed,evighed,stadighed,elendighed,stridighed,herlighed,festlighed,betænkelighed,forkærlighed,tilbøjelighed,ligegyldighed,dygtighed,seværdighed,ulovlighed,forældremyndighed,dødelighed,uretfærdighed,frihedsrettighed,venlighed,tilgængelighed,uregelmæssighed,selvfølgelighed,næstekærlighed,uendelighed,ulejlighed,højtidelighed,mindehøjtidelighed,høflighed,villighed,fortræffelighed,alsidighed,kulturpersonlighed,uhyrlighed,førlighed,hyppighed,besværlighed,barmhjertighed,tophastighed,skrøbelighed,luftfugtighed,fjendtlighed,blufærdighed,urimelighed,rigtighed,andelslejlighed,bekvemmelighed,yderlighed,middelmådighed,lyksalighed,valgmenighed,treenighed,ubehagelighed,genvordighed,lydighed,væsentlighed,handlemulighed,finurlighed,uansvarlighed,tåbelighed,tvetydighed,læsefærdighed,vilkårlighed,lånemulighed,fortrædelighed,liderlighed,luksuslejlighed,udødelighed,redelighed,træghed,børnedødelighed,smålighed,uskyldighed,frimenighed,stoflighed,lovmæssighed,åndelighed,stuelejlighed,dristighed,mærkværdighed,overdødelighed,spidsfindighed,uduelighed,øvrighed,overdådighed,lejelejlighed,underfundighed,ærgerrighed,gensidighed,herskabslejlighed,taknemlighed,bankhemmelighed,brødremenighed,giftighed,umenneskelighed,penthouselejlighed,salighed,omhyggelighed,mindelighed,kombinationsmulighed,taglejlighed,samdrægtighed,behændighed,vederstyggelighed,pudsighed,gejstlighed,dybsindighed,behagelighed,særrettighed,sprogfærdighed,spydighed,sprogvanskelighed,uartighed,letsindighed,ejendommelighed,erkendtlighed,nederdrægtighed,voldelighed,yndighed,besynderlighed,hæslighed,udlændighed,dejlighed,kørelejlighed,stemmelighed,ubetydelighed,uanstændighed,elskværdighed,uforståelighed,moderkærlighed,venskabelighed,pointlighed,nedrighed,artighed,marchhastighed,vidtløftighed,håndgribelighed,skrivefærdighed,svagelighed,urørlighed,gebrækkelighed,ynkelighed,omstændelighed,tarvelighed,kvistlejlighed,brevhemmelighed,tvistighed,uundgåelighed,etværelseslejlighed,ringhed,barnagtighed,skyldighed,åndssvaghed,bedrøvelighed,drægtighed,afskyelighed,urigtighed,delelejlighed,prøvelejlighed,åndrighed,toværelserslejlighed,slibrighed,viderværdighed,trækningsrettighed,vitterlighed,velærværdighed,bevislighed,talefærdighed,byttelejlighed,pudseløjerlighed,skibslejlighed,faderkærlighed,forrettighed,klublejlighed,ærværdighed,snurrighed,evindelighed,artsmangfoldighed,højærværdighed,løjerlighed,skændighed,afsindighed,tilhørighed,overlydshastighed,sprogrigtighed,trerumslejlighed,femværelserslejlighed,samsvarighed,fiffighed,modsvarighed,attråværdighed,firværelserslejlighed,kristenkærlighed,halvandetværelseslejlighed,torumslejlighed,treværelserslejlighed,beskyttelseslighed,smudsighed,stormægtighed,endrægtighed,finholdighed,fireværelserslejlighed,sædighed,had-kærlighed	
4	rone	24	0.00147	24	0	krone,trone,skattekrone,drone,lysekrone,trækrone,femkrone,matrone,enkrone,prismekrone,tornekrone,hjulkrone,tokrone,minestrone,kejserkrone,tikrone,lammekrone,cicerone,chaperone,digekrone,jacketkrone,trevlekrone,grevekrone,amarone	
4	skab	201	0.00127	60	141	videnskab,egenskab,ondskab,lidenskab,naturvidenskab,statskundskab,kundskab,utroskab,galskab,kogalskab,vildskab,morskab,lægevidenskab,samfundsvidenskab,troskab,dovenskab,bagklogskab,sagkundskab,klogskab,kristendomskundskab,dårskab,medievidenskab,musikvidenskab,råddenskab,sundhedsvidenskab,sprogvidenskab,fuldskab,fagkundskab,arrigskab,filmvidenskab,retsvidenskab,oldtidskundskab,djævelskab,socialvidenskab,forkundskab,hedenskab,statsvidenskab,karakteregenskab,hundegalskab,drukkenskab,pseudovidenskab,humanvidenskab,folkesundhedsvidenskab,populærvidenskab,samfundskundskab,grundvidenskab,biovidenskab,mediekundskab,filmkundskab,geovidenskab,varekundskab,kælenskab,familiekundskab,erfaringsvidenskab,uklogskab,forklogskab,handelsvidenskab,køreegenskab,bullenskab,metavidenskab	selskab,regnskab,fællesskab,budskab,ægteskab,kendskab,landskab,mesterskab,mandskab,redskab,medlemskab,forsikringsselskab,venskab,datterselskab,flyselskab,forfatterskab,køleskab,bekendtskab,statsborgerskab,formandskab,beredskab,partnerskab,pladeselskab,årsregnskab,ejerskab,lederskab,verdensmesterskab,broderskab,repræsentantskab,aktieselskab,boligselskab,borgerskab,moderselskab,filmselskab,fangenskab,bofællesskab,følgeskab,holdingselskab,rigsfællesskab,værtskab,pengeskab,telefonselskab,tvangsægteskab,slægtskab,anpartsselskab,kammeratskab,naboskab,nødberedskab,efterladenskab,fjendskab,andelsselskab,klædeskab,alarmberedskab,moderskab,præsteskab,medborgerskab,makkerskab,leasingselskab,kontorlandskab,svangerskab,købmandskab,medejerskab,faderskab,søsterselskab,herskab,ordførerskab,kommanditselskab,forældreskab,skæbnefællesskab,medielandskab,kompagniskab,vagtselskab,garderobeskab,skuffeselskab,bjerglandskab,grevskab,ukendskab,fornuftsægteskab,præsidentskab,uvenskab,interessentskab,djævelskab,kriseberedskab,koncernregnskab,familieskab,hedenskab,fryseskab,fadderskab,katastrofeberedskab,månelandskab,kosteskab,barskab,teselskab,gesandtskab,overskab,formuefællesskab,småborgerskab,kystlandskab,skriveredskab,driftsregnskab,proformaægteskab,fiskeredskab,førerskab,underskab,bogskab,formynderskab,sømandskab,stinkskab,hjørneskab,krydsejerskab,landmandskab,børneægteskab,livegenskab,adelskab,søsterskab,tjenerskab,medarbejderskab,ridderskab,pyramideselskab,glædesbudskab,boligfællesskab,isskab,vægskab,skydeselskab,torturredskab,kommandantskab,linnedskab,næstformandskab,svaleskab,gæstevenskab,vornedskab,fostbroderskab,sponsorskab,jalousiskab,sejrsbudskab,vaneægteskab,dæksmandskab,regentskab,skibsmandskab,landsmandskab,svogerskab
4	ster	233	0.00120	166	67	minister,statsminister,borgmester,udenrigsminister,premierminister,mester,søster,finansminister,justitsminister,kulturminister,verdensmester,forsvarsminister,skatteminister,miljøminister,sundhedsminister,undervisningsminister,indenrigsminister,overborgmester,socialminister,erhvervsminister,master,trafikminister,fødevareminister,politimester,økonomiminister,integrationsminister,lillesøster,transportminister,energiminister,viceborgmester,udviklingsminister,gangster,storesøster,kapelmester,moster,kirkeminister,forskningsminister,magister,landbrugsminister,boligminister,balletmester,klimaminister,stormester,maskinmester,læremester,tømrermester,murermester,malermester,bagermester,slagtermester,vicestatsminister,postmester,ester,håndværksmester,medsøster,hofjægermester,roadster,koncertmester,coaster,bygmester,brygmester,tester,faster,glarmester,tvillingesøster,snedkermester,medister,hamster,halvsøster,ghettoblaster,polyester,brødrister,webmaster,mavepuster,smedemester,klister,varmemester,ceremonimester,fodermester,kaster,grønthøster,vagtmester,kassemester,glaspuster,filister,bademester,hovmester,kloakmester,tekster,fagminister,sprechstallmeister,toastmaster,havnemester,kryster,puster,flammekaster,fyrmester,skolemester,stjernekaster,spydkaster,navnesøster,tonemester,skræddermester,stedsøster,liguster,værkmester,brandmester,frister,ritmester,skatmester,lyskaster,lyster,kældermester,hushovmester,diskoskaster,scenemester,skuemester,toaster,filibuster,fægtemester,trøster,fæster,baluster,kvartermester,blikkenslagermester,showmaster,pilaster,poster,rister,glasmester,gravemester,syngemester,papsøster,slusemester,tremaster,defroster,kaffesøster,lusepuster,ulster,tugtemester,snekaster,gamemaster,lægsøster,støbemester,prøvemester,helsøster,languster,slagtemester,kanaster,hipster,raster,tomaster,blockbuster,femmaster,guldsmedemester,gørtlermester,gas- og vandmester,pjaster,dragster,ryster,vaskemester,firemaster,pallelaster,komposter,caster,kanister	orkester,mønster,symfoniorkester,register,kloster,foster,monster,semester,trækplaster,plaster,hylster,adfærdsmønster,reaktionsmønster,folkeregister,misfoster,bevægelsesmønster,polyester,synderegister,følelsesregister,jazzorkester,harmoniorkester,patronhylster,klister,nikotinplaster,dydsmønster,fantasifoster,kønsrollemønster,strygeorkester,hornorkester,handlingsmønster,nonnekloster,personregister,donorregister,kulturmønster,løbemønster,polster,jomfrukloster,trimester,amatørorkester,hæfteplaster,søvnmønster,tornyster,gråbrødrekloster,skyldnerregister,baluster,snitmønster,hulmønster,blæseorkester,strafferegister,cancerregister,bolster,karmeliterkloster,bloster,harlekinmønster,paternoster,sagsregister,sagregister,jugendmønster,raster,frøkenkloster,kapucinerkloster,p-plaster,klyster,hanefjedsmønster,fuldregister,johanniterkloster,puppehylster
4	itet	337	0.00107	332	5	kvalitet,aktivitet,realitet,kriminalitet,identitet,kapacitet,stabilitet,autoritet,kreativitet,solidaritet,facilitet,effektivitet,popularitet,minoritet,fleksibilitet,seksualitet,produktivitet,graviditet,livskvalitet,prioritet,intensitet,suverænitet,nationalitet,elektricitet,loyalitet,likviditet,nervøsitet,mentalitet,lokalitet,specialitet,integritet,mobilitet,legitimitet,kompleksitet,homoseksualitet,kontinuitet,brutalitet,modernitet,anonymitet,passivitet,majoritet,naivitet,originalitet,antikvitet,ustabilitet,etnicitet,autenticitet,intimitet,neutralitet,musikalitet,biodiversitet,immunitet,religiøsitet,diversitet,formalitet,banalitet,rationalitet,seriøsitet,førsteprioritet,aggressivitet,normalitet,overkapacitet,absurditet,kvantitet,anciennitet,aktualitet,funktionalitet,sentimentalitet,vitalitet,soliditet,aktiemajoritet,bandekriminalitet,maskulinitet,objektivitet,individualitet,generøsitet,topprioritet,spiritualitet,genialitet,ungdomskriminalitet,spontanitet,habilitet,fertilitet,virtuositet,radioaktivitet,inhabilitet,lydkvalitet,rentabilitet,vandkvalitet,trivialitet,eksklusivitet,ineffektivitet,mortalitet,sensibilitet,sensualitet,invaliditet,kuriositet,notabilitet,raritet,sanitet,inaktivitet,konformitet,elasticitet,subjektivitet,validitet,illoyalitet,sensitivitet,teknikalitet,radikalitet,humanitet,proportionalitet,negativitet,småkriminalitet,homogenitet,vulgaritet,celebritet,irrationalitet,stupiditet,positivitet,perversitet,morbiditet,krævementalitet,kausalitet,hyperaktivitet,virilitet,monumentalitet,bonitet,specificitet,universalitet,totalitet,regularitet,impulsivitet,deformitet,plasticitet,moralitet,eventualitet,animositet,ekstremitet,relativitet,flokmentalitet,sterilitet,irritabilitet,promiskuitet,senilitet,perfiditet,primitivitet,urbanitet,tonalitet,socialitet,frivolitet,abnormitet,affinitet,densitet,polaritet,jovialitet,entitet,excentricitet,repræsentativitet,biseksualitet,kalamitet,heteroseksualitet,intentionalitet,legalitet,melodiøsitet,singularitet,komplementaritet,obskønitet,parallelitet,idealitet,kræmmermentalitet,bestialitet,subtilitet,refleksivitet,dualitet,progressivitet,kollektivitet,viskositet,destruktivitet,respektabilitet,kollegialitet,paritet,nullitet,transseksualitet,andenprioritet,modalitet,simplicitet,intertekstualitet,pompøsitet,heterogenitet,diskontinuitet,kompatibilitet,intellektualitet,porøsitet,uniformitet,liberalitet,pluralitet,illegalitet,historicitet,massivitet,variabilitet,fatalitet,servilitet,mondænitet,rivalitet,anormalitet,egalitet,grandiositet,underekstremitet,egocentricitet,labilitet,unormalitet,toksicitet,reciprocitet,frigiditet,atonalitet,potentialitet,hypermobilitet,spasticitet,emotionalitet,nobilitet,inhumanitet,selektivitet,overekstremitet,linearitet,immobilitet,infantilitet,bipolaritet,familiaritet,plausibilitet,illikviditet,paternitet,irregularitet,publicitet,flokimmunitet,irreversibilitet,konvertibilitet,præsenilitet,infleksibilitet,vivacitet,immoralitet,asocialitet,hadkriminalitet,natalitet,græcitet,monstrøsitet,paradoksalitet,opacitet,futilitet,tredimensionalitet,restriktivitet,duktilitet,konstruktivitet,gravitet,konkavitet,festivitet,umoralitet,endimensionalitet,kongenialitet,immortalitet,fidelitet,hydroelektricitet,sekularitet,grammatikalitet,durabilitet,patogenitet,perpleksitet,etnocentricitet,kapillaritet,assertivitet,nasalitet,klassicitet,fraternitet,kommensurabilitet,receptivitet,rapiditet,opportunitet,differentiabilitet,simultanitet,femininitet,distinktivitet,heteronormativitet,konicitet,eksterritorialitet,perfektibilitet,intensivitet,præmaturitet,multimodalitet,debilitet,pseudonymitet,konveksitet,termoelektricitet,fotoelektricitet,reversibilitet,irreligiøsitet,vejstabilitet,konneksitet,suggestibilitet,offensivitet,rigiditet,agilitet,kavitet,periodicitet,profitabilitet,frontalitet,inhomogenitet,inkompatibilitet,illegitimitet,flerdimensionalitet,professionalitet,konduktivitet,kapabilitet,sonoritet,provinsialitet,depressivitet,inferioritet,puerilitet,ambiguitet,todimensionalitet,fragilitet,latinitet,permissivitet,grådlabilitet,nativitet,maternitet,frugalitet,suggestivitet,kordialitet,umusikalitet,preciøsitet,imbecilitet,cirkularitet,lascivitet	universitet,folkeuniversitet,admiralitet,epitet,kommunitet
4	mand	184	0.00089	184	0	formand,næstformand,talsmand,bestyrelsesformand,målmand,købmand,gerningsmand,rådmand,landmand,gruppeformand,ombudsmand,embedsmand,politimand,vismand,bagmand,julemand,forretningsmand,franskmand,ægtemand,nordmand,landsmand,sømand,forbrugerombudsmand,tillidsmand,rigmand,dørmand,vognmand,konfirmand,ophavsmand,erhvervsmand,styrmand,videnskabsmand,førstemand,farmand,eksmand,troldmand,drabsmand,finansmand,statsmand,overvismand,forligsmand,brandmand,sidemand,venstremand,voldsmand,bedemand,retsformand,hovedmand,menigmand,fællestillidsmand,sportsmand,ejermand,arbejdsmand,redningsmand,enkemand,tjenestemand,husmand,ankermand,mellemmand,fagmand,lagmand,oldermand,lægmand,bombemand,pølsemand,snemand,adelsmand,spillemand,tredjemand,dannemand,altmuligmand,skraldemand,folketingsmand,foregangsmand,tissemand,bondemand,lydmand,vagtmand,verdensmand,flyttemand,levemand,handelsmand,vandmand,herremand,opmand,frømand,stiftamtmand,overmand,stråmand,brormand,amtmand,banemand,begmand,spåmand,supermand,jernmand,hædersmand,domsmand,skønsmand,træmand,vildmand,befalingsmand,færgemand,havmand,gårdmand,mælkemand,murerarbejdsmand,kagemand,privatmand,vurderingsmand,ligemand,folketingsformand,fragtmand,rigsombudsmand,sprællemand,medicinmand,afholdsmand,bussemand,lensmand,machomand,plovmand,gourmand,bøhmand,langemand,yngstemand,kontaktmand,tækkemand,mørkemand,stormand,rorsmand,guttermand,lirekassemand,alvorsmand,fjerdemand,knudemand,nissemand,muskelmand,lygtemand,forstmand,patientombudsmand,bådsmand,fritidslandmand,tændstikmand,førstestyrmand,nullermand,hjemmelsmand,morgenmand,flovmand,sædemand,sendemand,voldgiftsmand,knokkelmand,tømmermand,synsmand,høvedsmand,andenstyrmand,fløjmand,motormand,sidstemand,buskmand,muselmand,klabautermand,udkigsmand,sysselmand,valgmand,dannebrogsmand,sjakformand,græsenkemand,orlogsmand,undermand,dæksmand,bedstemand,dressmand,eftermand,tamand,riddersmand,jordemodermand,fæstemand,donkeymand,syns- og skønsmand,bylandmand,sandwichmand,aldersformand,gør det selv-mand	
4	hold	74	0.00085	0	74		forhold,indhold,landshold,ophold,hjemmehold,forbehold,sammenhold,tophold,parforhold,medhold,tilhørsforhold,førstehold,fodboldhold,bundhold,rejsehold,mesterhold,andethold,udehold,studieophold,kærlighedsforhold,misforhold,vedligehold,magtforhold,styrkeforhold,mådehold,tæskehold,baghold,håndboldhold,tillidsforhold,parkeringsforhold,træningsophold,seniorhold,tilhold,juniorhold,underhold,elitehold,førerhold,dyrehold,polititilhold,nathold,kontraktforhold,produktionsforhold,husdyrhold,kurophold,skiftehold,bytteforhold,leveforhold,iltindhold,skudhold,gudsforhold,tredjehold,hushold,kvæghold,kolesterolindhold,kontorhold,modtageforhold,langdistanceforhold,svinehold,sagforhold,førstedivisionshold,fuglehold,umådehold,avishold,modhold,krohold,hofhold,B-hold,signal-støj-forhold,renhold,A-hold,C-hold,fladeindhold,had-kærligheds-forhold,hjortehold
4	rden	42	0.00081	41	1	verden,orden,dagsorden,omverden,størrelsesorden,færden,verdensorden,underverden,uorden,medieverden,torden,bankverden,forretningsorden,samfundsorden,finansverden,vorden,retsorden,drømmeverden,rangorden,begrebsverden,gadeuorden,tankeverden,hakkeorden,voksenverden,frimurerorden,teatertorden,husorden,skoleverden,åndeverden,lilleverden,tredjeverden,afværgedagsorden,jesuiterorden,nummerorden,efterverden,slagorden,skinverden,yderverden,franciskanerorden,cistercienserorden,bogstavorden	norden
4	ejde	65	0.00077	5	60	fejde,blodfejde,slægtsfejde,stammefejde,pennefejde	arbejde,samarbejde,forarbejde,overarbejde,håndarbejde,vejarbejde,papirarbejde,hjælpearbejde,hjemmearbejde,børnearbejde,gruppearbejde,feltarbejde,lejde,benarbejde,tvangsarbejde,natarbejde,byggearbejde,detektivarbejde,deltidsarbejde,dobbeltarbejde,slavearbejde,merarbejde,fodarbejde,sorgarbejde,holdarbejde,sæsonarbejde,murerarbejde,udearbejde,kvalitetsarbejde,træskærerarbejde,sisyfosarbejde,rutinearbejde,pillearbejde,strafarbejde,emnearbejde,distancearbejde,akkordarbejde,skærmarbejde,pligtarbejde,hestearbejde,fjernarbejde,elevarbejde,måneskinsarbejde,knoklearbejde,korpusarbejde,malearbejde,muldvarpearbejde,dagarbejde,kropsarbejde,halvdagsarbejde,udendørsarbejde,heldagsarbejde,dagsarbejde,herkulesarbejde,nørklearbejde,fuskearbejde,polsterarbejde,korttidsarbejde,delarbejde,trællearbejde
4	inde	93	0.00076	87	6	kvinde,veninde,vinde,sinde,sangerinde,skuespillerinde,elskerinde,grevinde,talskvinde,tinde,heltinde,værtinde,nethinde,gudinde,lærerinde,forfatterinde,svigerinde,kejserinde,slimhinde,danserinde,karrierekvinde,hertuginde,forkvinde,hinde,forretningskvinde,trommehinde,erhvervskvinde,forstanderinde,hornhinde,husbestyrerinde,tjenerinde,løvinde,ophavskvinde,troldkvinde,bedsteveninde,rivalinde,herskerinde,fyrstinde,pianistinde,slyngveninde,hyrdinde,kammerherreinde,slavinde,tillidskvinde,præstinde,hjerteveninde,balletdanserinde,helgeninde,foregangskvinde,mavedanserinde,jomfruhinde,priorinde,kunstnerinde,gemalinde,videnskabskvinde,digterinde,sportskvinde,forligskvinde,adelskvinde,violinistinde,trælkvinde,hjernehinde,penneveninde,rådkvinde,fosterhinde,konsulinde,regnbuehinde,bestyrerinde,skæbnegudinde,bughinde,vestalinde,lungehinde,kærminde,provstinde,pastorinde,ulvinde,senehinde,blinkhinde,bindehinde,tamarinde,garnvinde,dannekvinde,konventualinde,konfirmandinde,skedehinde,infantinde,flyværtinde	minde,ærinde,fortidsminde,svinkeærinde,byærinde,jammersminde
4	lads	80	0.00072	78	2	plads,arbejdsplads,andenplads,parkeringsplads,førsteplads,tredjeplads,sejlads,legeplads,campingplads,byggeplads,praktikplads,markedsplads,losseplads,genbrugsplads,siddeplads,gårdsplads,læreplads,rasteplads,tilskuerplads,sengeplads,spalteplads,sidsteplads,kapsejlads,flyveplads,skueplads,gravplads,kampplads,boplads,sportsplads,studieplads,holdeplads,ladeplads,benplads,friplads,soveplads,begravelsesplads,handelsplads,ståplads,hjemmearbejdsplads,tilhørerplads,stadeplads,krigsskueplads,stamplads,tumleplads,lejrplads,busholdeplads,yngleplads,landingsplads,hædersplads,byggelegeplads,forplads,standplads,skabsplads,vinduesplads,gydeplads,valplads,kanosejlads,vendeplads,vægplads,bådeplads,stejleplads,aflæggeplads,liggeplads,spildplads,køjeplads,skrammellegeplads,orkesterplads,restplads,udenomsplads,tømmerplads,tørreplads,fyldplads,skydeplads,materialeplads,dæksplads,brætsejlads,lasteplads,p-plads	palads,stillads
4	sion	115	0.00071	114	1	kommission,diskussion,pension,konklusion,version,division,vision,mission,fusion,dimension,depression,eksplosion,revision,invasion,illusion,førtidspension,passion,folkepension,præcision,recession,refleksion,ekspansion,transmission,aggression,profession,session,emission,kollision,inklusion,kapitalpension,eksklusion,refusion,provision,pression,ekskursion,læsion,television,procession,fremtidsvision,aversion,koncession,suspension,blodtransfusion,supervision,progression,percussion,desillusion,erosion,invalidepension,coverversion,returkommission,halvpension,vinterdepression,perversion,tillægspension,yndlingsaversion,paneldiskussion,skolekommission,digression,transfusion,succession,alderspension,jamsession,helpension,dimission,kompression,decision,hundepension,regression,perkussion,korrosion,emulsion,allusion,ungdomspension,datatransmission,repression,fleksion,intension,infusion,fission,implosion,konfession,anneksion,konversion,enkepension,excision,diffusion,konfusion,tension,betaversion,permission,egenpension,ekstension,inversion,selvpension,dekompression,recension,krydsrevision,kohæsion,konvulsion,dispersion,adhæsion,torsion,introversion,retransmission,ekstroversion,retorsion,diversion,demission,elision,konneksion,retrofleksion,degression,accession	symposion
4	eske	41	0.00069	15	26	støbeske,sveske,teske,groteske,freske,grydeske,spiseske,humoreske,burleske,måleske,potageske,smageske,fugeske,barneske,skummeske	menneske,medmenneske,magtmenneske,overmenneske,bymenneske,undermenneske,kvindemenneske,ordensmenneske,friluftsmenneske,fortidsmenneske,urmenneske,privatmenneske,slangemenneske,umenneske,vanemenneske,gennemsnitsmenneske,selskabsmenneske,abemenneske,morgenmenneske,hjemmemenneske,hulemenneske,pligtmenneske,neandertalmenneske,B-menneske,forstandsmenneske,A-menneske
4	iker	203	0.00068	203	0	politiker,musiker,kritiker,analytiker,historiker,klassiker,akademiker,komiker,tekniker,dramatiker,parlamentariker,alkoholiker,mekaniker,skeptiker,kommunalpolitiker,fysiker,lokalpolitiker,elektriker,aktieanalytiker,keramiker,toppolitiker,kunsthistoriker,grafiker,jazzmusiker,fanatiker,lyriker,systemkritiker,matematiker,romantiker,kemiker,rockmusiker,diabetiker,teoretiker,optiker,praktiker,kyniker,landspolitiker,allergiker,psykoanalytiker,kunstkritiker,botaniker,litteraturkritiker,statistiker,automekaniker,bioanalytiker,satiriker,pragmatiker,astrofysiker,filharmoniker,mystiker,kroniker,nyklassiker,taktiker,atomfysiker,europaparlamentariker,idéhistoriker,biker,religionshistoriker,nostalgiker,magiker,biokemiker,levebrødspolitiker,symfoniker,excentriker,genetiker,flymekaniker,kammermusiker,æstetiker,tandtekniker,popmusiker,klimaskeptiker,spastiker,datamatiker,kliniker,prædiker,folkemusiker,lydtekniker,kriminaltekniker,geofysiker,polemiker,astmatiker,kulturhistoriker,etiker,standupkomiker,neurotiker,miljøtekniker,melankoliker,kirkehistoriker,agnostiker,ironiker,epileptiker,rigsstatistiker,industritekniker,maskintekniker,realpolitiker,bluesmusiker,naturhistoriker,føniker,elektronikmekaniker,stoiker,scenetekniker,semiotiker,byggetekniker,finmekaniker,typotekniker,gnostiker,laboratorietekniker,hysteriker,logiker,samtidshistoriker,dogmatiker,logistiker,mimiker,tadsjiker,nationalromantiker,koleriker,systematiker,senromantiker,erotiker,kernefysiker,egocentriker,heraldiker,kapelmusiker,elektrotekniker,geokemiker,metafysiker,teletekniker,kosmetiker,flegmatiker,numismatiker,skovtekniker,polytekniker,obstetriker,platoniker,afatiker,empiriker,grammatiker,kemotekniker,migræniker,fuldblodspolitiker,geotekniker,helsefysiker,eklektiker,sangviniker,syfilitiker,mellemtekniker,diagnostiker,aldersdiabetiker,fonetiker,hermeneutiker,nyromantiker,socialhistoriker,kiropraktiker,idylliker,dialektiker,nekromantiker,pyrotekniker,voldsromantiker,angstneurotiker,homiletiker,elegiker,ortorektiker,metodiker,geobotaniker,VVS-tekniker,epiker,bulimiker,reumatiker,statiker,elektroniker,fjernsynstekniker,apoplektiker,asteniker,pantomimiker,telemekaniker,karismatiker,prosaiker,hektiker,aritmetiker,prognostiker,tragiker,hæretiker,blasfemiker,personalhistoriker,retoriker,psykotekniker,maniker,kiromantiker,oratoriker,didaktiker,epigrafiker,paralytiker,skolastiker,akustiker,højromantiker,anorektiker,diætetiker,semantiker,dyslektiker,økumeniker,skismatiker,pykniker,dysfatiker	
4	kole	50	0.00066	50	0	skole,folkeskole,højskole,efterskole,handelshøjskole,friskole,musikskole,handelsskole,privatskole,ungdomsskole,landbohøjskole,grundskole,kostskole,aftenskole,planteskole,realskole,lærerhøjskole,specialskole,produktionsskole,lejrskole,statsskole,folkehøjskole,professionshøjskole,daghøjskole,danseskole,officersskole,rideskole,kommuneskole,centralskole,sygeplejeskole,køreskole,købmandsskole,pigeskole,lilleskole,søndagsskole,enhedsskole,forskole,flinkeskole,døveskole,førskole,dagskole,fysioterapeutskole,brevskole,hjælpeskole,barneskole,centerskole,pogeskole,ergoterapeutskole,eksternatskole,åbenplanskole	
4	ktør	52	0.00065	52	0	direktør,instruktør,redaktør,aktør,chefredaktør,filminstruktør,vicedirektør,sportsdirektør,underdirektør,kommunaldirektør,bankdirektør,inspektør,skoleinspektør,generaldirektør,kriminalinspektør,politiinspektør,teaterdirektør,kulturredaktør,projektør,medredaktør,konstruktør,landinspektør,skoledirektør,socialdirektør,overinspektør,viceinspektør,sceneinstruktør,konduktør,brandinspektør,akupunktør,programredaktør,udlandsredaktør,brevkasseredaktør,undervisningsinspektør,hovedredaktør,kronikredaktør,undervisningsdirektør,manuduktør,struktør,førstedirektør,ordbogsredaktør,rygestopinstruktør,sporvognskonduktør,branddirektør,flyveinstruktør,lektør,kollektør,korrektør,traktør,fabriksinspektør,desinfektør,bygningskonduktør	
4	mhed	20	0.00063	20	0	virksomhed,opmærksomhed,ensomhed,dumhed,grusomhed,kedsomhed,konsulentvirksomhed,ømhed,servicevirksomhed,voldsomhed,lønsomhed,morsomhed,tosomhed,nemhed,lobbyvirksomhed,grimhed,forlagsvirksomhed,enkeltmandsvirksomhed,ubetænksomhed,IT-virksomhed	
4	sker	75	0.00063	74	1	dansker,forsker,tysker,svensker,fisker,elsker,seniorforsker,efterforsker,nydansker,hersker,lystfisker,fremtidsforsker,valgforsker,hjerneforsker,klimaforsker,medieforsker,sprogforsker,udlandsdansker,mejetærsker,basker,polarforsker,husker,enehersker,vinduesvisker,opvasker,indpisker,sportsfisker,naturforsker,religionsforsker,kræftforsker,førsteelsker,kønsforsker,visker,udenlandsdansker,gammeldansker,slægtsforsker,fusker,fredsforsker,etrusker,genforsker,maveplasker,hjemmetysker,fluefisker,vasker,strandvasker,navneforsker,søvnforsker,behersker,industrifisker,læseforsker,grundforsker,folkemindeforsker,kratlusker,lemmedasker,konfliktforsker,pisker,havfisker,perlefisker,slavepisker,gransker,stenfisker,monegasker,finlandssvensker,pølsetysker,ditmarsker,lusker,projektforsker,tærsker,oldgransker,hjulpisker,branddasker,rudevasker,krybfisker,madagasker	maveplasker
4	gang	90	0.00061	90	0	omgang,adgang,fremgang,udgang,tilgang,afgang,indgang,årgang,overgang,tankegang,gennemgang,nedgang,tilbagegang,skolegang,opgang,undergang,modgang,arbejdsgang,solnedgang,balancegang,tomgang,enegang,svalegang,lønnedgang,rettergang,solopgang,græsgang,sejrsgang,medgang,forretningsgang,øregang,landgang,internetadgang,trappeopgang,stavgang,bortgang,rundgang,kirkegang,fodgængerovergang,lediggang,nødudgang,kavalergang,fødegang,midtergang,stuegang,bølgegang,bodsgang,sagsgang,bagindgang,holmgang,kapgang,søgang,tiggergang,altergang,forgang,netadgang,ordretilgang,postgang,dybgang,handlingsgang,søjlegang,sædafgang,minegang,buegang,gåsegang,bersærkergang,trappegang,vandgang,løbegang,baggang,toggang,løngang,irgang,sneglegang,bagudgang,skridtgang,pasgang,arvegang,armgang,altangang,tonegang,riffelgang,canossagang,skruegang,skabsgang,åregang,blodgang,vindelgang,tromlegang,koromgang	
4	asse	101	0.00060	101	0	masse,klasse,kasse,sparekasse,statskasse,terrasse,pensionskasse,middelklasse,postkasse,pengekasse,verdensklasse,børnehaveklasse,overklasse,gearkasse,arbejderklasse,brevkasse,biomasse,særklasse,papkasse,stærekasse,underklasse,værktøjskasse,prisklasse,brystkasse,vandmasse,grimasse,arvemasse,basse,topklasse,vægtklasse,flyttekasse,talentmasse,sandkasse,mellemklasse,tagterrasse,boligmasse,sygekasse,madkasse,muskelmasse,gymnasieklasse,altankasse,rugekasse,cigarkasse,mesterklasse,redekasse,fælleskasse,modtageklasse,fuglekasse,vildbasse,parallelklasse,spradebasse,fugemasse,kokasse,lirekasse,turistklasse,afgangsklasse,havgasse,rodekasse,bulderbasse,høkasse,mælkekasse,lyskasse,papirmasse,sænkekasse,brokkasse,ordklasse,spartelmasse,brumbasse,melasse,førstehjælpskasse,lånekasse,mejsekasse,kukkasse,centerklasse,træmasse,lønklasse,sættekasse,skarnbasse,sufflørkasse,læseklasse,hjælpeklasse,modtagelsesklasse,glemmekasse,barkasse,skatteklasse,smadderkasse,atommasse,guldbasse,vandreklasse,skærekasse,forbindskasse,hjemklasse,kædekasse,pakkasse,karkasse,skramlekasse,obsklasse,a-kasse,klemkasse,rumlekasse,skrumlekasse	
4	sdag	60	0.00060	60	0	torsdag,onsdag,tirsdag,fødselsdag,gårsdag,arbejdsdag,årsdag,forbundsdag,rigsdag,grundlovsdag,skærtorsdag,bryllupsdag,nytårsdag,børnefødselsdag,omsorgsdag,dødsdag,markedsdag,børnehjælpsdag,valentinsdag,idrætsdag,valdemarsdag,karensdag,skæringsdag,allehelgensdag,lillejuleaftensdag,tiårsdag,konfirmationsdag,askeonsdag,genforeningsdag,hundredårsdag,forfaldsdag,helligtrekongersdag,mikkelsdag,månedsdag,mortensdag,sankthansdag,allesjælesdag,etårsfødselsdag,glædesdag,ottetimersdag,sekstenårsfødselsdag,halvfjerdsårsfødselsdag,Mariæ bebudelsesdag,nittenårsfødselsdag,trediveårsfødselsdag,firsårsfødselsdag,attenårsfødselsdag,halvtredsårsfødselsdag,tychobrahesdag,fjortenårsfødselsdag,halvfemsårsfødselsdag,syttenårsfødselsdag,tresårsfødselsdag,trettenårsfødselsdag,femtenårsfødselsdag,tolvårsfødselsdag,fyrreårsfødselsdag,Kristi himmelfartsdag,tyveårsfødselsdag,treårsfødselsdag	
4	mmer	148	0.00059	83	65	sommer,dommer,efterkommer,hammer,svømmer,sensommer,hummer,landsdommer,forsommer,smagsdommer,drømmer,kræmmer,stammer,selskabstømmer,strammer,glimmer,vækstfremmer,jomfruhummer,femmer,isenkræmmer,lægdommer,byretsdommer,eftersommer,overdommer,krammer,jammer,summer,linjedommer,midsommer,bedømmer,publikummer,emmer,kriminaldommer,forhammer,opstrammer,dunhammer,civildommer,slangetæmmer,dagdrømmer,slummer,brummer,klaverstemmer,kødhammer,lægtehammer,løvetæmmer,kummer,sidedommer,rygsvømmer,brystsvømmer,hosekræmmer,skærsommer,dybvandshummer,dyretæmmer,dørhammer,kattejammer,pianostemmer,urtekræmmer,damphammer,torshammer,fredsdommer,murerhammer,klaphammer,bissekræmmer,hemmelighedskræmmer,kløfthammer,fagfællebedømmer,indian summer,stemmer,pikhammer,instagrammer,kludekræmmer,frisvømmer,planerhammer,næsehårstrimmer,bænkhammer,mælkeskummer,flammehæmmer,skægtrimmer,spidshammer,ejdammer,flækhammer,ommer,sættedommer	nummer,telefonnummer,kammer,hummer,handelskammer,postnummer,ekstranummer,glimmer,gaskammer,personnummer,slagnummer,spisekammer,tømmer,skatkammer,flimmer,gravkammer,fruentimmer,fupnummer,pulterkammer,temanummer,andetkammer,hjertekammer,drivtømmer,mørkekammer,toldkammer,særnummer,glansnummer,deputeretkammer,hjerteflimmer,sovekammer,torturkammer,katalognummer,serienummer,matrikelnummer,lønkammer,trykkammer,studerekammer,forrådskammer,paradenummer,frinummer,forkammer,løbenummer,atomnummer,ekkokammer,førstekammer,skonummer,karlekammer,journalnummer,lokalnummer,brændkammer,klovnenummer,områdenummer,privatnummer,tagkammer,bravurnummer,slusekammer,hofnummer,hjemmenummer,rustkammer,CVR-nummer,gavntømmer,vragtømmer,CPR-nummer,garderobenummer,kvistkammer
4	eter	87	0.00058	33	54	kilometer,meter,centimeter,kvadratmeter,millimeter,parameter,kubikmeter,diameter,kvadratkilometer,musketer,konkurrenceparameter,etagemeter,hyldemeter,trompeter,kvadratcentimeter,sekundmeter,kubikcentimeter,newtonmeter,rummeter,mikrometer,væltepeter,salpeter,dummepeter,perimeter,decimeter,kilopondmeter,hektometer,dekameter,vigtigpeter,kilogrammeter,chilesalpeter,luskepeter,norgesalpeter	parameter,barometer,taxameter,termometer,konkurrenceparameter,kateter,alkometer,speedometer,newtonmeter,stegetermometer,parkometer,mikrometer,salpeter,kronometer,heksameter,voltmeter,amperemeter,manometer,ergometer,magnetometer,potentiometer,hygrometer,valgbarometer,seismometer,spirometer,ohmmeter,digitaltermometer,variometer,kviksølvtermometer,wattmeter,fotometer,fahrenheittermometer,densitometer,celsiustermometer,optometer,takometer,gyrometer,chilesalpeter,norgesalpeter,telemeter,audiometer,aræometer,vakuummeter,galvanometer,luxmeter,sømmometer,pupillometer,goniometer,kviksølvbarometer,kalorimeter,hydrometer,narkometer,planimeter,pentameter
4	ment	106	0.00056	6	100	cement,kompliment,konsument,understatement,rapidcement,portlandcement	arrangement,parlament,argument,element,engagement,dokument,instrument,fundament,eksperiment,management,temperament,incitament,moment,monument,abonnement,supplement,bombardement,segment,sortiment,signalement,fragment,departement,klassement,regiment,ræsonnement,medikament,kompliment,akkompagnement,avancement,establishment,etablissement,reglement,raffinement,livregiment,musikinstrument,bygningsreglement,møblement,statement,hovedargument,tankeeksperiment,traktement,ornament,slutdokument,pigment,måleinstrument,salgsargument,usikkerhedsmoment,sediment,strengeinstrument,pergament,settlement,overraskelsesmoment,blæseinstrument,firmament,gravmonument,divertissement,tæppebombardement,trænregiment,jugement,soloinstrument,understatement,strygeinstrument,forlystelsesetablissement,rudiment,ressentiment,lavement,filament,rytmeinstrument,tangentinstrument,deplacement,detachement,komplement,avertissement,liniment,slaginstrument,guvernement,assortiment,irritament,husarregiment,disengagement,garderegiment,possement,ferment,nivellement,springavancement,endossement,zinkliniment,tørelement,åbent hus-arrangement,emolument,postament,lineament,ligament,termoelement,piment,konnossement,enjambement,ekskrement,kantonnement,changement
4	lder	89	0.00055	82	7	forælder,alder,skulder,kælder,anmelder,middelalder,bedsteforælder,foredragsholder,pensionsalder,tidsalder,holder,folder,tolder,menneskealder,gennemsnitsalder,guldalder,beholder,lavalder,levealder,stenalder,bogholder,tovholder,jernalder,bronzealder,overgangsalder,vinkælder,filmanmelder,bodybuilder,sokkeholder,fastholder,underholder,statholder,kulkælder,kilder,voksenalder,skadevolder,senmiddelalder,rekordholder,teltholder,krybekælder,ilder,mikrofonholder,kopholder,gasbeholder,værtshusholder,brystholder,hofteholder,højmiddelalder,stadeholder,førskolealder,cykelkælder,kompostbeholder,myndighedsalder,samværsforælder,barnealder,bopælsforælder,ordskvalder,voksealder,fremkalder,trodsalder,atomalder,strømpeholder,brandmelder,lømmelalder,kontaktforælder,lyseholder,toårsalder,singleforælder,fyrkælder,smælder,husholder,stedforælder,skvalder,viktualiekælder,småbørnsforælder,toiletpapirholder,værnepligtsalder,christiansfelder,kornsmælder,TV-anmelder,sagvolder,ungpigealder	mylder,bulder,menneskemylder,rabalder,ordskvalder,tankemylder,skvalder
4	råde	25	0.00053	1	24	fråde	område,lokalområde,hovedstadsområde,forretningsområde,landområde,sundhedsområde,naturområde,nærområde,yderområde,byområde,indsatsområde,vådområde,fokusområde,kystområde,randområde,stofområde,sprogområde,delområde,legeområde,byudviklingsområde,virkeområde,udeområde,takstområde,sagområde
4	unkt	48	0.00051	2	46	adjunkt,seminarieadjunkt	tidspunkt,udgangspunkt,punkt,synspunkt,højdepunkt,omdrejningspunkt,standpunkt,vendepunkt,midtpunkt,lyspunkt,samlingspunkt,brændpunkt,knudepunkt,kritikpunkt,bristepunkt,lavpunkt,holdepunkt,hovedpunkt,nulpunkt,frysepunkt,tyngdepunkt,yderpunkt,kogepunkt,anklagepunkt,fikspunkt,kardinalpunkt,kontrapunkt,toppunkt,klagepunkt,smertepunkt,støttepunkt,mætningspunkt,træfpunkt,mødetidspunkt,sendetidspunkt,angrebspunkt,smeltepunkt,sigtepunkt,berøringspunkt,ankepunkt,dugpunkt,orgelpunkt,flammepunkt,g-punkt,tvistepunkt,dødpunkt
4	tter	105	0.00051	101	4	forfatter,datter,rytter,fortsætter,latter,iværksætter,lytter,fætter,cykelrytter,tilflytter,oversætter,medforfatter,bosætter,tekstforfatter,svigerdatter,kutter,krimiforfatter,beskytter,sætter,iscenesætter,etter,igangsætter,fiskekutter,globetrotter,hjælperytter,smutter,steddatter,besætter,kætter,mutter,afslutter,opdrætter,otter,trendsætter,babysitter,skarpretter,radiolytter,blotter,fatter,bitter,fribytter,benytter,jetsetter,hånlatter,beretter,spritter,transmitter,fraflytter,udnytter,indflytter,bytter,tandbeskytter,konkursrytter,knæbeskytter,klassementrytter,splatter,setter,spotter,udbytter,dåselatter,peanutbutter,udflytter,kluklatter,plejedatter,grandfætter,paragrafrytter,halvfætter,principrytter,regelrytter,chancerytter,datterdatter,bonusdatter,ildspåsætter,skridtbeskytter,opretter,udsætter,spidsgatter,guddatter,ensretter,nitter,gudsbespotter,autoopretter,håndsætter,plotter,skoggerlatter,søsterdatter,pantsætter,afretter,tagrytter,fotosætter,sønnedatter,broderdatter,tonesætter,checkrytter,vekselrytter,chatter,evadatter,skralderlatter,cutter,gordonsetter,boykotter	gitter,glitter,kølergitter,flitter
4	ække	40	0.00050	27	13	række,årrække,sprække,perlerække,flække,brevsprække,kongerække,foredragsrække,tankerække,sejrsrække,knagerække,talrække,medietække,mesterrække,kvindetække,publikumstække,tallerkenrække,dørsprække,skærmtække,tekstrække,børnetække,dametække,herretække,potensrække,hundetække,tække,kvotientrække	dække,skydække,bunddække,isdække,medietække,kvindetække,publikumstække,skærmtække,børnetække,dametække,hundetække,tække,herretække
4	tand	81	0.00050	80	1	stand,afstand,tilstand,forstand,modstand,påstand,genstand,bistand,husstand,velstand,bestand,opstand,udviklingsbistand,vandstand,undtagelsestilstand,ulandsbistand,stilstand,akselafstand,helbredstilstand,fortand,værdigenstand,lærerstand,gåafstand,henstand,brugsgenstand,våbenstilstand,blomsterstand,bondestand,choktilstand,handelsstand,normaltilstand,uforstand,hajtand,civilstand,hugtand,anstand,pyntegenstand,dvaletilstand,middelstand,cykelafstand,kindtand,vildtbestand,nipsgenstand,ægtestand,håndstand,visdomstand,guldtand,alarmtilstand,hjørnetand,grundvandsstand,trancetilstand,rokketand,foderstand,løvetand,gnidningsmodstand,kællingetand,stødtand,mælketand,urtilstand,gangafstand,mellemstand,sjælstilstand,adelstand,skydemodstand,frøkenstand,stifttand,håndværkerstand,onenightstand,galtetand,savtand,flytilstand,frugtstand,habitualtilstand,højvandstand,undertand,overtand,frastand,harvetand,tvetand,termometerstand	onenightstand
4	orie	57	0.00044	39	18	historie,verdenshistorie,kunsthistorie,kalorie,kulturhistorie,forhistorie,kærlighedshistorie,litteraturhistorie,livshistorie,glorie,solstrålehistorie,røverhistorie,løgnehistorie,idéhistorie,vandrehistorie,kirkehistorie,sygehistorie,godnathistorie,samtidshistorie,bibelhistorie,retshistorie,religionshistorie,naturhistorie,videnskabshistorie,sproghistorie,industrihistorie,molbohistorie,socialhistorie,solohistorie,cikorie,ammestuehistorie,personalhistorie,kilokalorie,vrøvlehistorie,helgenglorie,almanakhistorie,skipperhistorie,infusorie,aarhushistorie	laboratorie,territorie,konservatorie,auditorie,kommissorie,dentallaboratorie,sproglaboratorie,sanatorie,moratorie,krematorie,suppositorie,musikkonservatorie,ambulatorie,svangreambulatorie,søterritorie,observatorie,oratorie,alkoholambulatorie
4	esse	48	0.00042	48	0	interesse,presse,adresse,prinsesse,messe,kronprinsesse,tresse,dagspresse,finesse,delikatesse,stewardesse,bogmesse,baronesse,verdenspresse,højmesse,tristesse,egeninteresse,akkuratesse,postadresse,petitesse,komtesse,seddelpresse,internetadresse,ugepresse,dødsmesse,trykpresse,hjemmeadresse,kermesse,boulevardpresse,noblesse,officersmesse,rotationspresse,togstewardesse,sensationspresse,duchesse,almeninteresse,populærpresse,sjælemesse,maitresse,vinpresse,desinteresse,guldtresse,halmpresse,IP-adresse,ballepresse,fromesse,e-postadresse,e-mailadresse	
4	ller	85	0.00041	80	5	spiller,skuespiller,fodboldspiller,fortæller,landsholdsspiller,bestseller,thriller,medspiller,udstiller,afspiller,håndboldspiller,tennisspiller,stregspiller,modspiller,forslagsstiller,kontroller,nøglespiller,stiller,stamspiller,møller,kantspiller,bagspiller,historiefortæller,tæller,controller,skakspiller,markspiller,pladespiller,ishockeyspiller,seycheller,filmskuespiller,boldspiller,jegfortæller,karakterskuespiller,kuller,dobbeltsculler,kontraktspiller,galler,singlesculler,skridttæller,kilometertæller,kriller,fløjtespiller,kartoffelskræller,tørvetriller,kortspiller,plimsoller,triptæller,orgelspiller,geigertæller,taskenspiller,reservespiller,violinspiller,hockeyspiller,stemmetæller,harpespiller,hasardspiller,cricketspiller,båndspiller,opstiller,falskspiller,kveller,økuller,sculler,gærdespiller,cigarruller,fedtspiller,båndafspiller,tredjepersonsfortæller,dukkespiller,dråbetæller,dummyspiller,førstepersonsfortæller,CD-afspiller,frispiller,storyteller,skjaller,udskiller,marstaller,båndtæller	kriller,fnuller,dillerdaller,hverken-eller,enten-eller
4	eder	82	0.00041	75	7	leder,skoleleder,projektleder,partileder,regeringsleder,topleder,skibsreder,vejleder,statsleder,speeder,centerleder,mellemleder,indsatsleder,naturvejleder,rejseleder,driftsleder,studievejleder,fjeder,korleder,gruppeleder,reder,kampagneleder,stationsleder,forhandlingsleder,kursusleder,flyveleder,tilbeder,mødeleder,arbejdsleder,klanleder,programleder,funktionsleder,æggeleder,køkkenleder,indleder,lynafleder,halvleder,udsteder,erhvervsvejleder,superleder,sveder,spreder,auktionsleder,humørspreder,helbreder,hyggespreder,kørselsleder,ceder,kortudsteder,saltspreder,gyllespreder,ringsteder,stålfjeder,rusvejleder,familievejleder,smittespreder,drivfjeder,opinionsleder,gødningsspreder,praktikleder,varmeleder,spiralfjeder,trussereder,partreder,springfjeder,grusspreder,urfjeder,slagfjeder,trykfjeder,afleder,næstveder,nysteder,pelsbereder,nulleder,meneder	kateder,polyeder,tetraeder,oktaeder,heksaeder,pentaeder,dekaeder
4	smål	26	0.00040	0	26		spørgsmål,slagsmål,modersmål,sejrsmål,søgsmål,skudsmål,udflugtsmål,hundeslagsmål,gruppesøgsmål,tvivlsspørgsmål,masseslagsmål,stridsspørgsmål,skyldspørgsmål,livsmål,rigsmål,detailspørgsmål,læringsmål,skændsmål,principspørgsmål,verdensmål,tidsspørgsmål,trickspørgsmål,kardinalspørgsmål,landsmål,venusmål,udråbsspørgsmål
4	itik	55	0.00040	55	0	politik,kritik,udenrigspolitik,finanspolitik,sikkerhedspolitik,kulturpolitik,energipolitik,socialpolitik,flygtningepolitik,klimapolitik,landbrugspolitik,retspolitik,integrationspolitik,kommunalpolitik,lokalpolitik,personalepolitik,blokpolitik,selvkritik,værdipolitik,skolepolitik,partipolitik,storpolitik,realpolitik,ældrepolitik,landspolitik,rygepolitik,symbolpolitik,handelspolitik,trafikpolitik,alkoholpolitik,seniorpolitik,kildekritik,sprogpolitik,kulturkritik,lønpolitik,efterkritik,verdenspolitik,identitetspolitik,kunstkritik,geopolitik,regionalpolitik,kostpolitik,indkomstpolitik,etbarnspolitik,ideologikritik,inddæmningspolitik,fagpolitik,midterpolitik,visnepolitik,nykritik,isolationspolitik,enkeltsagspolitik,tekstkritik,agrarpolitik,korridorpolitik	
4	slag	68	0.00040	0	68		forslag,lovforslag,indslag,afslag,beslutningsforslag,udslag,opslag,anslag,omslag,folkeslag,tilbageslag,beslag,nedslag,fodslag,hammerslag,bagslag,kanonslag,spareforslag,håndslag,samfundslag,sværdslag,hjerteslag,overslag,trylleslag,søslag,dueslag,hedeslag,pulsslag,punktnedslag,bogomslag,gennemslag,prislag,vingeslag,isslag,ridderslag,dørslag,regnslag,taktslag,kølleslag,pladeomslag,stenslag,bølgeslag,islag,håndkantslag,stokkeslag,klokkeslag,bråvallaslag,smudsomslag,modforslag,pudslag,timeslag,genopslag,kuskeslag,luftslag,vinkelbeslag,bedeslag,hovslag,tilslag,isoleringslag,bommesislag,kvarterslag,efterslag,overhåndsslag,ramslag,underslag,tøjreslag,bislag,paskvilbeslag
4	arti	21	0.00040	1	20	havarti	parti,kommunistparti,støtteparti,arbejderparti,midterparti,søsterparti,protestparti,hængeparti,bagparti,ungdomsparti,japarti,soloparti,forparti,udbryderparti,restparti,nejparti,bækkenparti,broderparti,agterparti,fornuftsparti
4	ager	122	0.00039	119	3	deltager,passager,lønmodtager,manager,teenager,anklager,lager,modtager,iagttager,trommeslager,initiativtager,bager,beslutningstager,arbejdstager,ledsager,arvtager,ballademager,klager,prismodtager,båndoptager,aftager,låntager,urmager,gidseltager,blikkenslager,bedrager,flypassager,skomager,uromager,jager,opdager,medpassager,filmmager,plattenslager,kupmager,projektmager,forsikringstager,slager,livsledsager,optager,bistandsmodtager,spasmager,pottemager,værktøjsmager,medaljetager,opdrager,hattemager,fupmager,jetjager,mirakelmager,drager,værnemager,videobåndoptager,fidusmager,glasmager,kassettebåndoptager,karetmager,buntmager,dukkemager,pristager,sejlmager,pølsemager,støvdrager,mager,handskemager,spilopmager,tidtager,instrumentmager,radiomodtager,socialbedrager,videooptager,vinsmager,præmietager,rebslager,kurvemager,parykmager,våbendrager,amager,guldmager,sværddrager,intrigemager,diskussionsdeltager,ildrager,træskomager,bøssemager,forsager,vager,versemager,roeoptager,stolemager,boligtager,kartoffeloptager,dyrplager,hjulmager,tværdrager,humbugmager,visemager,selvplager,saddelmager,vitsmager,paradoksmager,vrager,komplotmager,panikmager,skjolddrager,plager,glarmager,ransager,OL-deltager,kartager,betonmager,tweenager,keyaccountmanager,paukeslager,spektakelmager,floskelmager,frasemager,vindmager,varetager	lager,fjernlager,frilager
4	uppe	45	0.00039	45	0	gruppe,suppe,målgruppe,aldersgruppe,styregruppe,terrorgruppe,kontrolgruppe,risikogruppe,kundegruppe,interessegruppe,følgegruppe,kontaktgruppe,fokusgruppe,restgruppe,mødregruppe,undergruppe,puppe,socialgruppe,lavindkomstgruppe,pigegruppe,nyhedsgruppe,tomatsuppe,sødsuppe,referencegruppe,ærtesuppe,løgsuppe,knippelsuppe,højrisikogruppe,drengegruppe,aspargessuppe,marginalgruppe,vennegruppe,landegruppe,backinggruppe,messingsuppe,fædregruppe,skildpaddesuppe,legegruppe,erfagruppe,oksehalesuppe,kørvelsuppe,kråsesuppe,højstatusgruppe,juliennesuppe,lavstatusgruppe	
4	tale	54	0.00039	54	0	aftale,samtale,omtale,tiltale,fredsaftale,udtale,telefonsamtale,nytårstale,fortale,jobsamtale,påtale,rammeaftale,takketale,købsaftale,presseomtale,skåltale,festtale,båltale,eksklusivaftale,særaftale,ansættelsessamtale,foromtale,parallelaftale,låneaftale,brandtale,enetale,licensaftale,rundbordssamtale,saltomortale,salgstale,grænseaftale,hyldesttale,medarbejdersamtale,dundertale,hovedaftale,tungetale,underhåndsaftale,forældresamtale,tryghedsaftale,jomfrutale,trontale,tekstudtale,tordentale,portrætsamtale,ikkespredningsaftale,gentlemanaftale,hadtale,kollektivaftale,tågetale,teknologiaftale,trelandeaftale,barteraftale,femme fatale,skole-hjem-samtale	
4	lede	44	0.00038	3	41	politikerlede,livslede,selvlede	billede,forbillede,verdensbillede,bybillede,lydbillede,fjendebillede,skræmmebillede,spejlbillede,nærbillede,glansbillede,tidsbillede,røntgenbillede,lysbillede,sindbillede,selvbillede,nøgenbillede,stjernebillede,skærmbillede,modbillede,idealbillede,stillbillede,gruppebillede,profilbillede,vrangbillede,gudebillede,skyggebillede,klassebillede,ordbillede,helgenbillede,vrængbillede,prøvebillede,genrebillede,fantasibillede,fantombillede,skriftbillede,fikserbillede,brystbillede,gøglebillede,satsbillede,genbillede,boudoirbillede
4	ance	62	0.00037	62	0	chance,alliance,balance,distance,ambulance,nuance,tolerance,assistance,renæssance,betalingsbalance,leverance,elegance,seance,korrespondance,performance,arrogance,ubalance,avance,intolerance,romance,handelsbalance,restance,trance,lægeambulance,nultolerance,breakdance,fajance,langdistance,bruttoavance,ekstravagance,kontrachance,clairvoyance,terrorbalance,væskebalance,kulance,mellemdistance,ignorance,squaredance,assurance,underleverance,nonchalance,overbalance,hormonbalance,gevinstchance,reassurance,mesalliance,underbalance,hjerteambulance,juleassistance,kapitalbalance,kortdistance,vakance,laktoseintolerance,saldobalance,linedance,tripelalliance,råbalance,kontenance,fifty-fifty-chance,kværulance,usance,ækvidistance	
4	rson	20	0.00037	20	0	person,hovedperson,enkeltperson,privatperson,forsøgsperson,kontaktperson,nøgleperson,fagperson,biperson,testperson,talsperson,interviewperson,titelperson,mandsperson,støtteperson,transperson,standsperson,forperson,ankerperson,attentionperson	
4	ende	82	0.00036	52	30	studerende,fjende,pårørende,legende,henseende,kende,rejsende,bordende,øverstkommanderende,næstkommanderende,rende,tidende,opdagelsesrejsende,bagende,lærerstuderende,tagrende,arvefjende,jurastuderende,forretningsrejsende,uddannelsessøgende,medstuderende,dividende,sejlrende,handelsrejsende,forende,dødsfjende,fodende,vandrende,ferierejsende,boligsøgende,selvstuderende,forskerstuderende,skotrende,rollehavende,blende,tiende,benende,begblende,andetårsstuderende,fjernstuderende,agende,zinkblende,førsteårsstuderende,andendelsstuderende,handlende,logerende,kursusstuderende,ph.d.-studerende,førstedelsstuderende,hornblende,audienssøgende,elende	vedkommende,udseende,anliggende,vidende,foretagende,forlydende,forehavende,tilgodehavende,velbefindende,særkende,forgodtbefindende,pålydende,mellemværende,indestående,ildebefindende,tyende,udestående,forlangende,tilliggende,anbringende,foregivende,andragende,befindende,indseende,dybgående,almenbefindende,elende,præbende,udvisende,velgående
4	gave	28	0.00035	28	0	opgave,udgave,julegave,kerneopgave,førsteudgave,mandelgave,bryllupsgave,nådegave,originaludgave,prisopgave,specialopgave,netudgave,konfirmationsgave,agave,vuggegave,hadegave,morgengave,billigudgave,piratudgave,adventsgave,votivgave,klassikerudgave,etbindsudgave,tekstopgave,krydsogtværsopgave,multiple choice-opgave,bibliofiludgave,gudegave	
4	ykke	56	0.00035	14	42	ulykke,lykke,trafikulykke,dødsulykke,krykke,drukneulykke,færdselsulykke,højresvingsulykke,nykke,krigslykke,soloulykke,eneulykke,primadonnanykke,aleneulykke	stykke,smykke,regnestykke,teaterstykke,samtykke,sidestykke,tilløbsstykke,modstykke,rundstykke,brudstykke,viskestykke,kunststykke,aktstykke,musikstykke,mesterstykke,arvestykke,svendestykke,udstyrsstykke,lærestykke,sætstykke,klippestykke,jordstykke,topstykke,halssmykke,mundstykke,rygstykke,livstykke,sofastykke,vovestykke,pragtstykke,midterstykke,bærestykke,sprængstykke,fodstykke,linjestykke,similismykke,gangestykke,kronestykke,schallstykke,topassmykke,tykke,forlængerstykke
4	port	52	0.00034	52	0	rapport,sport,transport,eksport,import,motorsport,sejlsport,support,carport,kampsport,politirapport,godstransport,skisport,hjemtransport,travsport,elitesport,byport,ladeport,nationalsport,halvårsrapport,holdsport,ekstremsport,søsport,søtransport,folkesport,sygetransport,parallelimport,gitterport,systemeksport,rosport,vandsport,vintersport,bovport,situationsrapport,kultureksport,æresport,kontaktsport,sluseport,heliport,reeksport,skydesport,gangsport,chokrapport,vippeport,terrænsport,reimport,parasport,e-sport,merimport,vandresport,ægeksport,interimsrapport	
4	ding	187	0.00033	187	0	melding,blanding,udlænding,spænding,udmelding,tilmelding,vending,indblanding,indvending,vinding,islænding,landing,forbrænding,udsending,tilbagemelding,binding,afbrænding,bemanding,sammenblanding,kending,branding,landvinding,høvding,kovending,sygemelding,vesterlænding,udvinding,indånding,tinding,sending,brænding,mellemlanding,afspænding,tænding,olding,mødding,vanding,forbinding,bedding,nødlanding,udmunding,udvanding,munding,teambuilding,afrunding,budding,forsvinding,udtynding,madding,højspænding,kunstvanding,indvinding,vejrmelding,håndevending,bodybuilding,runding,skynding,køkkenmødding,afvanding,ligbrænding,indmelding,indbinding,blomsterbinding,stranding,udånding,langtidssygemelding,underbemanding,nedbrænding,omvending,fejlmelding,hjernevinding,moderbinding,alminding,nedblænding,stavnsbinding,afmelding,foderblanding,fejlfinding,iblanding,optænding,fortynding,beverding,opbinding,sydlænding,himmerlænding,raskmelding,genvinding,indianerhøvding,fastspænding,leding,sikkerhedslanding,genindvinding,klarmelding,flodmunding,tredjegradsforbrænding,tilsanding,raceblanding,mavelanding,landkending,framelding,spinding,faderbinding,blænding,snowboarding,opblanding,samsending,overblænding,andengradsforbrænding,grunding,sammenbinding,nidding,opspænding,vejmelding,dobbeltbinding,spejlvending,overfladespænding,overspænding,antænding,fading,overbemanding,blinding,efterspænding,lavspænding,brystspænding,ånding,skibinding,hjemmebrænding,saftspænding,østerlænding,hanggliding,opsending,ålænding,rombudding,indmunding,drypvanding,fylding,oprunding,jubelolding,afblænding,fjernkending,afbinding,trepunktsvending,plumbudding,indebrænding,førstegradsforbrænding,gilding,fjordmunding,dørfylding,udbrænding,genfinding,fjerding,bespænding,boarding,surfriding,cheerleading,panamabinding,tvinding,genudvinding,kuldeblanding,nedrunding,tilsending,underbinding,normannerhøvding,blindlanding,randing,U-vending,trending,vognfading,tilbinding,gårding,wakeboarding,skateboarding,gnistspænding,bording,eftersending,østlænding,svinebinding,downloading,røding,uploading,eftertænding,udbinding,udpinding,volding,efterbrænding,fortænding,børstebinding	
4	fund	27	0.00033	0	27		samfund,velfærdssamfund,lokalsamfund,trossamfund,verdenssamfund,retssamfund,påfund,parallelsamfund,informationssamfund,landsbysamfund,klassesamfund,overvågningssamfund,forbrugersamfund,vidensamfund,øsamfund,statssamfund,risikosamfund,nærsamfund,gravfund,mosefund,kommunikationssamfund,mandssamfund,sprogsamfund,jordfund,totredjedelssamfund,lavvækstsamfund,alternativsamfund
4	nder	137	0.00032	131	6	modstander,vinder,englænder,kalender,forstander,hollænder,begynder,kender,under,grønlænder,inder,julekalender,afsender,synder,opfinder,bartender,cylinder,nybegynder,sjællænder,vender,sender,finder,matchvinder,pokalvinder,koriander,blender,prisvinder,stander,sølvvinder,højskoleforstander,enspænder,brænder,thailænder,afbrænder,fartsynder,forkynder,langelænder,fender,brander,indsender,newzealænder,abortmodstander,ynder,bogbinder,ladestander,stifinder,stationsforstander,salamander,reminder,kunstkender,helleflynder,tænder,medaljevinder,formynder,hypokonder,tender,stavblender,islænder,skærebrænder,vinkender,flamlænder,pakkekalender,opstander,velynder,ugander,benzinstander,støjsender,rwander,menneskekender,pladevender,flynder,palisander,ekspander,selvbinder,binder,blomsterbinder,kerteminder,rigsforstander,irlænder,distanceblænder,newfoundlænder,bunsenbrænder,bekender,nederlænder,spinder,burgunder,efterbrænder,grunder,betonblander,børstenbinder,skolopender,brændevinsbrænder,cigartænder,oleander,lollænder,fortynder,mordbrænder,vodbinder,planlægningskalender,estlænder,nodevender,giftblander,kortbølgesender,evighedskalender,glimtænder,højlænder,teglbrænder,stenvender,shetlænder,marketender,gastænder,gotlænder,rheinlænder,frederikssunder,tospænder,finlænder,blokkalender,bjørnespinder,svejsebrænder,laplænder,bøgespinder,FM-sender,plænevander,ringspinder,penselspinder,cementblander,swazilænder,CD-brænder,blander,påminder,ildlænder	under,tønder,vidunder,gelænder,dunder,palisander
4	list	103	0.00031	103	0	journalist,bilist,cyklist,solist,specialist,socialist,nationalist,fundamentalist,finalist,motorcyklist,idealist,spritbilist,individualist,cellist,kapitalist,liberalist,sportsjournalist,stylist,realist,evangelist,populist,vokalist,spøgelsesbilist,flugtbilist,moralist,folkesocialist,freelancejournalist,surrealist,traditionalist,instrumentalist,materialist,generalist,semifinalist,royalist,civilist,højrepopulist,imperialist,nationalsocialist,stilist,filatelist,radiojournalist,gaullist,symbolist,cembalist,rationalist,internationalist,nihilist,orientalist,højrenationalist,naturalist,eksistentialist,minimalist,kvindelist,funktionalist,kolonialist,blist,industrialist,elitebilist,monopolist,socialrealist,fatalist,novellist,strukturalist,syndikalist,formalist,nyrealist,føderalist,nyliberalist,detaillist,alkoholist,parcellist,vitalist,kabbalist,loyalist,krigslist,violoncellist,billedjournalist,ulykkesbilist,multikulturalist,søndagsbilist,sensualist,dualist,dokumentalist,neutralist,universalist,gonzojournalist,pluralist,radikalist,panelist,petitjournalist,kancellist,pointillist,regionalist,nominalist,somnambulist,professionalist,socialliberalist,spiritualist,annalist,rabulist,anglist,intellektualist,machiavellist	
4	raft	39	0.00031	39	0	kraft,arbejdskraft,hestekraft,drivkraft,gennemslagskraft,atomkraft,sammenhængskraft,handlekraft,dømmekraft,vindkraft,købekraft,tyngdekraft,slagkraft,kernekraft,livskraft,håndkraft,vandkraft,modstandskraft,naturkraft,trækkraft,urkraft,kulkraft,sprængkraft,donkraft,centrifugalkraft,maskinkraft,bærekraft,indbildningskraft,grokraft,produktivkraft,retskraft,virkekraft,lovkraft,beviskraft,spændkraft,lærerkraft,a-kraft,dådskraft,bønskraft	
4	isme	389	0.00031	388	1	optimisme,turisme,terrorisme,racisme,kommunisme,organisme,kapitalisme,mekanisme,nazisme,realisme,socialisme,nationalisme,antisemitisme,liberalisme,kynisme,mikroorganisme,modernisme,fascisme,islamisme,konservatisme,professionalisme,humanisme,ekstremisme,fundamentalisme,idealisme,feminisme,populisme,autisme,egoisme,pessimisme,buddhisme,fanatisme,marxisme,individualisme,nepotisme,minimalisme,alkoholisme,imperialisme,protektionisme,kulturradikalisme,materialisme,katolicisme,aktivisme,pluralisme,totalitarisme,surrealisme,patriotisme,lobbyisme,ateisme,multikulturalisme,markedsmekanisme,pragmatisme,parlamentarisme,prisme,postmodernisme,bilisme,socialrealisme,zionisme,anakronisme,privatbilisme,kolonialisme,ekspressionisme,opportunisme,impressionisme,kannibalisme,naturalisme,stalinisme,funktionalisme,narcissisme,perfektionisme,dokumentarisme,hinduisme,analfabetisme,symbolisme,centralisme,protestantisme,sexisme,nationalsocialisme,relativisme,moralisme,radikalisme,klassicisme,forsvarsmekanisme,nihilisme,puritanisme,vandalisme,eksistentialisme,aforisme,eufemisme,rationalisme,eskapisme,cyklisme,dualisme,anarkisme,masseturisme,darwinisme,militarisme,magnetisme,sadisme,højreekstremisme,forbrugerisme,provinsialisme,kubisme,hooliganisme,amatørisme,chauvinisme,heroisme,nyliberalisme,positivisme,separatisme,universalisme,determinisme,pacifisme,pietisme,internationalisme,altruisme,grundtvigianisme,industrialisme,kommercialisme,masochisme,okkultisme,satanisme,føderalisme,hedonisme,mysticisme,nynazisme,metabolisme,elektromagnetisme,isolationisme,ekvilibrisme,kollektivisme,konstruktivisme,strukturalisme,højrepopulisme,formalisme,mandschauvinisme,fatalisme,amerikanisme,vitalisme,leninisme,kreationisme,kulturimperialisme,feudalisme,futurisme,nyklassicisme,sadomasochisme,historicisme,fetichisme,traditionalisme,naivisme,dadaisme,jihadisme,maoisme,monoteisme,ekshibitionisme,eksorcisme,holisme,skepticisme,spiritisme,statsterrorisme,revisionisme,voyeurisme,shamanisme,bolsjevisme,sufisme,absolutisme,intellektualisme,sekterisme,kommunitarisme,reduktionisme,hellenisme,konfucianisme,konformisme,absurdisme,højreradikalisme,salafisme,mongolisme,pladderhumanisme,avantgardisme,manierisme,lukkemekanisme,eksotisme,dogmatisme,kulturturisme,anglicisme,stoicisme,sensualisme,victorianisme,vegetarisme,gnosticisme,zenbuddhisme,vulkanisme,nykonservatisme,utilitarisme,defaitisme,socialkonstruktivisme,calvinisme,økoturisme,behaviorisme,låsemekanisme,nyrealisme,regionalisme,reformisme,paternalisme,neologisme,dekonstruktivisme,farisæisme,primitivisme,fauvisme,romantisme,revanchisme,empirisme,senkapitalisme,demokratisme,højrenationalisme,socialliberalisme,kosmopolitisme,lutheranisme,elitisme,skandinavisme,nudisme,konkretisme,obskurantisme,irrationalisme,subjektivisme,brutalisme,utopisme,monisme,spiritualisme,dilettantisme,etnocentrisme,panteisme,despotisme,eklekticisme,naturisme,antropomorfisme,purisme,æsteticisme,antagonisme,historisme,platonisme,monetarisme,sikhisme,infantilisme,parkinsonisme,gaullisme,konsumerisme,evolutionisme,eurocentrisme,muhamedanisme,animisme,betonkommunisme,antimilitarisme,botulisme,synkretisme,lesbianisme,polyteisme,ekspansionisme,transvestisme,syndikalisme,venstreekstremisme,snobbisme,kolorisme,verisme,neutralisme,venstreradikalisme,nykolonialisme,negativisme,brandesianisme,germanisme,freudianisme,erotisme,shiisme,messianisme,interventionisme,agnosticisme,vegetarianisme,royalisme,solipsisme,veganisme,senmodernisme,korporatisme,reumatisme,bureaukratisme,tropisme,sentimentalisme,syllogisme,teisme,nominalisme,privatkapitalisme,mormonisme,judaisme,akademisme,trotskisme,panarabisme,truisme,nymarxisme,objektivisme,daoisme,urbanisme,shintoisme,gigantisme,baptisme,atavisme,deisme,albinisme,antropocentrisme,parallelisme,varefetichisme,hegelianisme,sofisme,dramadokumentarisme,papisme,georgisme,pointillisme,sunnisme,postkommunisme,bioterrorisme,vanvidsbilisme,monopolisme,privatisme,decentralisme,indeterminisme,alpinisme,lamaisme,nyfascisme,korporativisme,machiavellisme,thomisme,rigorisme,partikularisme,tachisme,brahmanisme,bonapartisme,klerikalisme,totemisme,lamarckisme,hermafroditisme,nordisme,tsarisme,epikuræisme,voluntarisme,panafrikanisme,arkaisme,nomadisme,gallicisme,isomorfisme,panslavisme,eudaimonisme,komparatisme,panamerikanisme,supranaturalisme,svecisme,latinisme,psykologisme,norvagisme,perspektivisme,somnambulisme,vulgarisme,uniformisme,kretinisme,kantianisme,pangermanisme,barthianisme,danisme,unitarisme,cæsarisme,malthusianisme,kvietisme,presbyterianisme,hegemonisme,kabbalisme,doktrinarisme,seksualisme,græcisme,idiotisme,jesuitisme,panhellenisme,unionisme,hypnotisme,flagellantisme,synkronisme,morfinisme,kulturisme,metodisme,konsonantisme,polycentrisme,vokalisme	prisme
4	irke	20	0.00031	18	2	kirke,folkekirke,domkirke,frikirke,klosterkirke,sognekirke,landsbykirke,rundkirke,romerkirke,stavkirke,oldkirke,pavekirke,moderkirke,korskirke,vejkirke,vandrekirke,højkirke,annekskirke	virke,samvirke
4	blik	20	0.00030	4	16	republik,forbundsrepublik,folkerepublik,bananrepublik	øjeblik,overblik,henblik,indblik,tilbageblik,udblik,sideblik,falkeblik,havblik,røntgenblik,dræberblik,bølgeblik,kenderblik,slutblik,hvidblik,argusblik
4	dent	22	0.00030	21	1	præsident,student,ministerpræsident,vicepræsident,korrespondent,dissident,retspræsident,respondent,udvekslingsstudent,alderspræsident,krigskorrespondent,resident,konseilspræsident,overpræsident,tronprætendent,superintendent,descendent,prætendent,ascendent,mordent,occident	incident
4	erie	67	0.00030	30	37	serie,ferie,sommerferie,bakterie,tegneserie,efterårsferie,vinterferie,juleferie,charterferie,materie,skoleferie,storbyferie,colibakterie,bilferie,filmserie,industriferie,arterie,bededagsferie,bondegårdsferie,læseferie,kroferie,vandreferie,nerie,storebededagsferie,kanoferie,aktivferie,koronararterie,knoldbakterie,stavbakterie,kør selv-ferie	kriterie,succeskriterie,mysterie,imperie,miljøministerie,indenrigsministerie,udviklingsministerie,beskæftigelsesministerie,klimaministerie,landbrugsministerie,fødestedskriterie,transportministerie,justitsministerie,erhvervsministerie,skatteministerie,socialministerie,klimakterie,dødskriterie,forsvarsministerie,boligministerie,energiministerie,økonomiministerie,udenrigsministerie,ressortministerie,finansministerie,kulturministerie,finansimperie,forskningsministerie,fagministerie,ministerie,fødevareministerie,forretningsministerie,kirkeministerie,trafikministerie,undervisningsministerie,statsministerie,sundhedsministerie
4	jder	51	0.00029	51	0	medarbejder,arbejder,spejder,maskinarbejder,gæstearbejder,socialarbejder,bygningsarbejder,landarbejder,hjælpearbejder,havnearbejder,specialarbejder,industriarbejder,metalarbejder,talentspejder,østarbejder,fabriksarbejder,servicemedarbejder,fremmedarbejder,bryggeriarbejder,skovarbejder,lagerarbejder,pigespejder,kommunikationsmedarbejder,migrantarbejder,postarbejder,slavearbejder,børnearbejder,lønarbejder,byggearbejder,kulminearbejder,tekstilarbejder,løsarbejder,jernbanearbejder,renovationsarbejder,ungarbejder,kommunalarbejder,søspejder,kulturarbejder,kloakarbejder,lejder,trykkeriarbejder,åndsarbejder,isoleringsarbejder,udviklingsmedarbejder,ekstraarbejder,IT-medarbejder,højder,jord- og betonarbejder,grubearbejder,kropsarbejder,civilarbejder	
4	rger	27	0.00028	27	0	borger,statsborger,medborger,skatteborger,burger,spørger,forsørger,samfundsborger,verdensborger,æresborger,hamburger,sjælesørger,unionsborger,bedsteborger,sovjetborger,småborger,luxembourger,eneforsørger,cheeseburger,spidsborger,udspørger,forespørger,oldenborger,familieforsørger,frederiksberger,frederiksborger,EU-borger	
4	jælp	25	0.00027	25	0	hjælp,kontanthjælp,nødhjælp,hjemmehjælp,førstehjælp,dødshjælp,bistandshjælp,lægehjælp,starthjælp,selvhjælp,krisehjælp,lektiehjælp,mødrehjælp,retshjælp,hushjælp,socialhjælp,medhjælp,fattighjælp,nabohjælp,våbenhjælp,fødselshjælp,studentermedhjælp,autohjælp,akuthjælp,tørkehjælp	
4	land	48	0.00027	3	45	dixieland,ødeland,taffeland	udland,medlemsland,hjemland,naboland,bagland,udviklingsland,fædreland,euroland,grænseland,uland,indland,fastland,industriland,opland,sommerland,østland,højland,badeland,ingenmandsland,værtsland,slaraffenland,modtagerland,tredjeland,moderland,vandland,vesterland,legeland,friland,broderland,tredjeverdensland,kerneland,søhøjland,lavland,formandsland,fjendeland,agerland,iland,bøhland,bjergland,vestland,østerland,sletteland,forland,fladland,lydland
4	atur	50	0.00027	38	12	natur,litteratur,temperatur,signatur,kandidatur,karikatur,skønlitteratur,faglitteratur,verdenslitteratur,statsadvokatur,statur,muskulatur,stuetemperatur,dagtemperatur,triviallitteratur,koloratur,kvadratur,nattemperatur,sekundærlitteratur,unatur,advokatur,nomenklatur,kiosklitteratur,rigsadvokatur,ligatur,spillernatur,emigrantlitteratur,makulatur,undergrundslitteratur,stukkatur,titulatur,registratur,smudslitteratur,politiadvokatur,enspændernatur,memoirelitteratur,kontrasignatur,e-signatur	diktatur,kandidatur,tastatur,kreatur,apparatur,militærdiktatur,armatur,klaviatur,advokatur,demokratur,imprimatur,ungkreatur
4	usik	39	0.00026	39	0	musik,rockmusik,folkemusik,popmusik,jazzmusik,kammermusik,dansemusik,populærmusik,verdensmusik,livemusik,underlægningsmusik,barokmusik,kormusik,baggrundsmusik,soulmusik,hornmusik,rapmusik,spillemandsmusik,fremtidsmusik,instrumentalmusik,technomusik,fusionsmusik,pigtrådsmusik,beatmusik,vokalmusik,reggaemusik,tolvtonemusik,borgermusik,stemningsmusik,diskomusik,elektronmusik,salonmusik,ledsagemusik,taffelmusik,programmusik,brugsmusik,bigbandmusik,kattemusik,klesmermusik	
4	tryk	56	0.00026	0	56		udtryk,indtryk,blodtryk,skattetryk,fingeraftryk,aftryk,håndtryk,højtryk,ansigtsudtryk,modtryk,helhedsindtryk,eftertryk,sanseindtryk,lavtryk,dæktryk,genoptryk,lufttryk,fagudtryk,overtryk,smagsindtryk,undertryk,optryk,slangudtryk,vandtryk,silketryk,særtryk,kraftudtryk,bogtryk,stoftryk,guldtryk,kobbertryk,olietryk,stentryk,linoleumstryk,fejltryk,akseltryk,påtryk,blåtryk,småtryk,dybtryk,gastryk,skillingstryk,fortryk,forhåndsindtryk,offsettryk,lystryk,flerfarvetryk,hovedtryk,bloktryk,blindtryk,voksaftryk,rentryk,bitryk,fladtryk,svagtryk,betryk
4	nter	55	0.00026	15	40	vinter,sprinter,printer,pointer,headhunter,panter,isvinter,planter,selvhenter,laserprinter,fimbulvinter,atomvinter,midvinter,korinter,sinter	center,plejecenter,asylcenter,indkøbscenter,storcenter,ældrecenter,butikscenter,kulturcenter,motionscenter,aktivitetscenter,universitetscenter,krisecenter,fitnesscenter,dagcenter,kraftcenter,kongrescenter,shoppingcenter,bycenter,socialcenter,solcenter,traumecenter,konferencecenter,datacenter,epicenter,beredskabscenter,rehabiliteringscenter,callcenter,kontrolcenter,modtagecenter,voksenuddannelsescenter,nervecenter,udrejsecenter,urocenter,industricenter,omsorgscenter,områdecenter,hjernecenter,døgncenter,mediacenter,AMU-center
4	ælde	37	0.00025	21	16	fælde,enevælde,brændenælde,nælde,vælde,bjælde,turistfælde,dødsfælde,musefælde,kobjælde,brandfælde,rottefælde,adelsvælde,smækfælde,fåmandsvælde,døvnælde,mælde,guldnælde,vindfælde,kanebjælde,blæresmælde	tilfælde,enevælde,fortilfælde,slagtilfælde,vælde,nødstilfælde,særtilfælde,ulykkestilfælde,tvivlstilfælde,grænsetilfælde,enkelttilfælde,førstegangstilfælde,papirvælde,adelsvælde,smittetilfælde,fåmandsvælde
4	olle	44	0.00025	43	1	rolle,hovedrolle,bolle,jolle,birolle,titelrolle,kønsrolle,nøglerolle,filmrolle,flødebolle,kasserolle,fastelavnsbolle,kødbolle,manderolle,optimistjolle,glansrolle,helterolle,grovbolle,finnjolle,stolle,karakterrolle,melbolle,fiskebolle,smørbolle,negerbolle,krydderbolle,chokoladebolle,kartebolle,sesambolle,punchebolle,mandsrolle,rosinbolle,fiskerjolle,snebolle,piratjolle,kragejolle,elskerrolle,kokosbolle,rissolle,focacciabolle,hækjolle,walesbolle,OK-jolle	oldekolle
4	edag	25	0.00025	25	0	fredag,skoledag,juledag,sygedag,mærkedag,dommedag,påskedag,spilledag,førstedag,hviledag,lukkedag,langfredag,bededag,pinsedag,torvedag,ugedag,sidstedag,flyttedag,skiftedag,navnedag,fastedag,liggedag,søgnedag,løbedag,overliggedag	
4	rift	88	0.00025	71	17	drift,overskrift,opskrift,skrift,bedrift,underskrift,fremdrift,forskrift,håndskrift,døgndrift,togdrift,påskrift,efterskrift,minedrift,udskrift,rovdrift,indskrift,stordrift,opdrift,afskrift,landbrugsdrift,gravskrift,dødsdrift,kønsdrift,seksualdrift,samdrift,selvopholdelsesdrift,skråskrift,domsudskrift,båndudskrift,kontoudskrift,kileskrift,blindskrift,runeindskrift,underoverskrift,lydskrift,kontinentaldrift,punktskrift,løsdrift,kapiteloverskrift,halvtimesdrift,skønskrift,formskrift,afdrift,omdrift,vekseldrift,blindeskrift,nedskrift,kodeskrift,renskrift,skriveskrift,billedskrift,spejlskrift,brødskrift,ildskrift,reliefskrift,sansserifskrift,petitskrift,brailleskrift,kursivskrift,printerudskrift,klarskrift,hieroglyfskrift,timinuttersdrift,tegnskrift,chifferskrift,blokskrift,stejlskrift,tyveminuttersdrift,versalskrift,totimersdrift	tidsskrift,skrift,anklageskrift,håndskrift,ugeskrift,efterskrift,udskrift,festskrift,båndudskrift,domsudskrift,smædeskrift,svarskrift,kontoudskrift,kildeskrift,månedsskrift,klageskrift,printerudskrift
4	nger	105	0.00025	105	0	finger,sanger,tilhænger,forgænger,pegefinger,forsanger,fodgænger,ringer,tommelfinger,operasanger,genganger,løsgænger,kirkegænger,slinger,håndlanger,springer,budbringer,anger,biografgænger,fanger,højdespringer,hunger,solfanger,kofanger,korsanger,popsanger,lillefinger,anhænger,kirkesanger,ørehænger,rocksanger,teatergænger,dobbeltgænger,koncertgænger,visesanger,rorgænger,udspringer,søvngænger,enegænger,hvalfanger,folkesanger,længdespringer,stangspringer,svinger,rottefænger,pilfinger,kammersanger,protestsanger,ringfinger,bondeanger,cliffhanger,langfinger,swinger,grænsegænger,bondefanger,bassanger,ganger,gårdsanger,cykelanhænger,trespringer,trampolinspringer,indtrænger,kapgænger,badutspringer,stavgænger,løvsanger,fuglefænger,sælfanger,forlænger,gransanger,lediggænger,rørsanger,fumlegænger,fluefanger,fedtfinger,blindgænger,pranger,stødfanger,tågænger,pølsefinger,diskenspringer,karolinger,minnesanger,refrænsanger,havesanger,overbringer,tornsanger,dråbefanger,kærsanger,omgænger,pasgænger,kabaretsanger,partigænger,gærdesanger,skovsanger,dyndspringer,operettesanger,klynger,sålegænger,græshoppesanger,hirschfænger,styltegænger,lykkebringer,merovinger,sivsanger	
4	ølge	27	0.00024	25	2	følge,bølge,rækkefølge,selvfølge,flodbølge,hedebølge,chokbølge,arvefølge,radiobølge,lydbølge,trykbølge,mikrobølge,senfølge,tronfølge,rangfølge,varmebølge,bærebølge,kuldebølge,hækbølge,kortbølge,tidsfølge,mellembølge,langbølge,trinfølge,trangfølge	følge,ligfølge
4	nomi	22	0.00024	21	1	økonomi,privatøkonomi,markedsøkonomi,samfundsøkonomi,gastronomi,autonomi,astronomi,planøkonomi,nationaløkonomi,oplevelsesøkonomi,driftsøkonomi,deleøkonomi,ergonomi,vidensøkonomi,blandingsøkonomi,undergrundsøkonomi,taksonomi,naturalieøkonomi,antinomi,agronomi,heteronomi	fysiognomi
4	tner	27	0.00023	26	1	kunstner,partner,samarbejdspartner,billedkunstner,gartner,tryllekunstner,handelspartner,multikunstner,samtalepartner,anlægsgartner,dansepartner,scenekunstner,portner,sexpartner,stadsgartner,livskunstner,falskmøntner,sparringpartner,tusindkunstner,tonekunstner,handelsgartner,trapezkunstner,blomstergartner,brugskunstner,sleepingpartner,sortekunstner	centner
4	brug	46	0.00023	14	32	misbrug,genbrug,sprogbrug,magtmisbrug,stofmisbrug,alkoholmisbrug,narkotikamisbrug,våbenbrug,blandingsmisbrug,aftenbrug,børnemisbrug,vinterbrug,helårsbrug,epo-misbrug	landbrug,forbrug,misbrug,genbrug,sprogbrug,privatforbrug,overforbrug,magtmisbrug,stofmisbrug,skovbrug,alkoholmisbrug,jordbrug,dambrug,ressourceforbrug,merforbrug,havbrug,havebrug,kvægbrug,agerbrug,narkotikamisbrug,familiebrug,storforbrug,fritidslandbrug,kollektivbrug,blandingsmisbrug,børnemisbrug,standbyforbrug,svedjebrug,egetforbrug,trevangsbrug,tovangsbrug,epo-misbrug
4	ence	25	0.00023	25	0	konkurrence,konference,kompetence,reference,pressekonference,præference,excellence,inkompetence,spidskompetence,difference,dekadence,kadence,fredskonference,diligence,eminence,videokonference,sixpence,gættekonkurrence,kondolence,absence,indifference,præmiekonkurrence,topkonference,korpulence,adhærence	
4	skud	34	0.00023	0	34		overskud,underskud,tilskud,startskud,indskud,bloktilskud,forskud,påskud,kosttilskud,stjerneskud,løntilskud,langskud,pletskud,børnetilskud,fejlskud,vildskud,udskud,vådeskud,topskud,grundskud,muldvarpeskud,hopskud,rodskud,bambusskud,hekseskud,strejfskud,skræmmeskud,kalktilskud,æbleskud,skumpelskud,nådeskud,flugtskud,hjerteskud,sammenskud
4	rhed	22	0.00023	22	0	sikkerhed,nærhed,usikkerhed,retssikkerhed,klarhed,storhed,trafiksikkerhed,uklarhed,færdselssikkerhed,knogleskørhed,særhed,sigtbarhed,træfsikkerhed,datasikkerhed,tapperhed,kostbarhed,flerhed,flyvesikkerhed,tunghørhed,stemmeflerhed,sjælsstorhed,IT-sikkerhed	
4	ktor	54	0.00022	54	0	sektor,lektor,faktor,rektor,traktor,spindoktor,doktor,sundhedssektor,reaktor,protektor,servicesektor,prorektor,kiropraktor,universitetslektor,projektor,atomreaktor,detektor,æresdoktor,havetraktor,metaldetektor,studielektor,motivationsfaktor,seminarielektor,stressfaktor,seminarierektor,vektor,inspektor,heksedoktor,tidsfaktor,løgnedetektor,solfaktor,reflektor,gymnasielektor,letvandsreaktor,overheadprojektor,kernereaktor,røgdetektor,formeringsreaktor,instruktor,aktor,beskyttelsesfaktor,chillfaktor,prosektor,induktor,primfaktor,konvektor,ejektor,transduktor,rhesusfaktor,refraktor,vivisektor,kontaktor,konduktor,injektor	
4	erne	48	0.00022	48	0	stjerne,hjerne,kerne,kaserne,superstjerne,verdensstjerne,filmstjerne,rockstjerne,bykerne,lanterne,ledestjerne,pinjekerne,barnestjerne,sangstjerne,cisterne,søstjerne,terne,atomkerne,solsikkekerne,cellekerne,nøddekerne,davidsstjerne,michelinstjerne,morgenstjerne,jødestjerne,kæmpestjerne,lucerne,klæbehjerne,lillehjerne,sauterne,dobbeltstjerne,guldstjerne,aftenstjerne,storhjerne,fiksstjerne,vindruekerne,betlehemsstjerne,bakkestjerne,fladstjerne,kaverne,blåstjerne,dagpragtstjerne,toplanterne,pragtstjerne,frøstjerne,skovstjerne,gardekaserne,varietéstjerne	
4	greb	36	0.00022	1	35	møggreb	angreb,begreb,indgreb,overgreb,terrorangreb,indbegreb,modangreb,jerngreb,kontraangreb,frontalangreb,vejgreb,kunstgreb,æresbegreb,fejlgreb,nøglebegreb,grundbegreb,gudsbegreb,ladegreb,kvælergreb,dørgreb,håndgreb,dobbeltgreb,stormangreb,overbegreb,misgreb,skinangreb,slynggreb,flankeangreb,pistolgreb,hyssingreb,underbegreb,slænggreb,tankangreb,undergreb,føregreb
4	gram	52	0.00021	0	52		program,kilogram,diagram,telegram,underholdningsprogram,principprogram,anagram,milligram,monogram,koncertprogram,piktogram,hologram,handlingsprogram,quizprogram,antivirusprogram,regionalprogram,elektrokardiogram,søjlediagram,nanogram,pentagram,epigram,skåneprogram,fonogram,kryptogram,seismogram,videogram,parallelogram,cirkeldiagram,kardiogram,aerogram,ideogram,elektroencefalogram,histogram,blokdiagram,stenogram,spektrogram,trepunktsprogram,dekagram,open source-program,cad-program,decigram,stereogram,CAD-program,centigram,organigram,femtogram,encefalogram,heksagram,indlæseprogram,rutediagram,hektogram,floragram
4	rand	28	0.00021	27	1	brand,strand,grand,sandstrand,skovbrand,badestrand,ildebrand,mordbrand,steppebrand,kødrand,koldbrand,miltbrand,halsbrand,doktorand,guldbrand,sørgerand,fløderand,forstrand,karamelrand,sårrand,synsrand,kraterrand,præriebrand,fribadestrand,støberand,alveolarrand,præparand	brand
4	valg	34	0.00021	0	34		udvalg,præsidentvalg,folketingsvalg,kommunalvalg,kulturudvalg,genvalg,socialudvalg,forretningsudvalg,finansudvalg,primærvalg,fravalg,ordvalg,nyvalg,førstevalg,kampvalg,midtvejsvalg,formandsvalg,kommunevalg,samarbejdsudvalg,skolevalg,tilvalg,omvalg,prøvevalg,kanonvalg,suppleringsvalg,fredsvalg,forvalg,responsumudvalg,indvalg,bortvalg,glosevalg,børn og unge-udvalg,gennemvalg,børne- og ungeudvalg
4	gdom	30	0.00021	30	0	sygdom,ungdom,fattigdom,rigdom,kræftsygdom,dårligdom,helligdom,børnesygdom,lungesygdom,folkesygdom,følgesygdom,infektionssygdom,kønssygdom,hudsygdom,øjensygdom,sindssygdom,erhvervssygdom,virussygdom,stofskiftesygdom,kredsløbssygdom,tropesygdom,blødersygdom,kvægsygdom,artsrigdom,mangelsygdom,detailrigdom,multisygdom,hjerte-kar-sygdom,Alzheimers sygdom,Parkinsons sygdom	
4	aner	128	0.00021	128	0	amerikaner,republikaner,japaner,albaner,indianer,iraner,afghaner,afrikaner,brasilianer,pakistaner,odenseaner,tibetaner,sydafrikaner,cubaner,talebaner,mexicaner,koreaner,nordkoreaner,sydkoreaner,nigerianer,marokkaner,kenyaner,colombianer,sydamerikaner,puritaner,germaner,afroamerikaner,grundtvigianer,jordaner,latinamerikaner,veganer,fredericianer,taiwaner,kosovoalbaner,amagerkaner,venezuelaner,lutheraner,mohikaner,jamaicaner,åndemaner,haitianer,nordafrikaner,randrusianer,sicilianer,muhamedaner,peruaner,horsensianer,napolitaner,aserbajdsjaner,korsikaner,trojaner,srilankaner,bolivianer,nordamerikaner,spartaner,kollegianer,venetianer,franciskaner,dominikaner,puertoricaner,liberianer,sudaner,ivorianer,uruguayaner,singaporeaner,anglikaner,costaricaner,rotarianer,mayaindianer,angolaner,freudianer,afrikaaner,helsingoraner,victorianer,soraner,nicaraguaner,honduraner,herlovianer,ecuadorianer,fijianer,vegetarianer,danskamerikaner,sydsudaner,papuaner,bhutaner,persianer,hawaiianer,korsoraner,panamaner,jungianer,omaner,salvadoraner,guatemalaner,burmaner,andorraner,siouxindianer,pommeraner,slagelseaner,tuvaluaner,samoaner,guineaner,botswaner,tonganer,løgstørianer,bahamaner,paraguayaner,cambodianer,apacheindianer,regensianer,mallorcaner,ækvatorialguineaner,guyaner,puebloindianer,javaner,aarhusianer,provinsianer,hillerødaner,antiguaner,dominicaner,skælskørianer,kantianer,vestsamoaner,lipizzaner,presbyterianer,centralafrikaner,barthianer,brandesianer,castilianer	
4	ater	35	0.00020	10	25	psykiater,sweater,skater,pater,børnepsykiater,tater,pædiater,frater,cater,geriater	teater,musikteater,børneteater,egnsteater,krater,dukketeater,amatørteater,amfiteater,totalteater,privatteater,friluftsteater,marionetteater,bombekrater,gruppeteater,vulkankrater,intimteater,skyggeteater,månekrater,eksperimentalteater,boulevardteater,værkstedsteater,turnéteater,caféteater,kabaretteater,mesterjakelteater
4	este	32	0.00020	32	0	kæreste,tjeneste,efterretningstjeneste,gudstjeneste,fortjeneste,ekskæreste,samfundstjeneste,militærtjeneste,tipstjeneste,udenrigstjeneste,bjørnetjeneste,vennetjeneste,sundhedstjeneste,streamingtjeneste,ambulancetjeneste,skoletjeneste,mindegudstjeneste,vagttjeneste,bedriftssundhedstjeneste,aftengudstjeneste,teletjeneste,konsulenttjeneste,fildelingstjeneste,spaghettigudstjeneste,onlinetjeneste,gentjeneste,kurertjeneste,nødtjeneste,ekstrafortjeneste,altertjeneste,weekendkæreste,dagtjeneste	
4	ndel	59	0.00020	58	1	handel,andel,svindel,boghandel,detailhandel,mandel,ejendel,samhandel,menneskehandel,frihandel,pendel,grænsehandel,valgsvindel,vinhandel,studehandel,udenrigshandel,vandel,kunsthandel,byttehandel,insiderhandel,slavehandel,landhandel,lavendel,tømmerhandel,internethandel,fiskehandel,forsikringssvindel,grønthandel,dyrehandel,trælasthandel,farvehandel,blomsterhandel,sortbørshandel,købmandshandel,antikvarboghandel,butikshandel,tuskhandel,spindel,rondel,produkthandel,bittermandel,vatrondel,kolonialhandel,saltmandel,strakshandel,transithandel,materialhandel,retshandel,vildthandel,viktualiehandel,øksnehandel,en gros-handel,glandel,indenrigshandel,strøghandel,spothandel,krakmandel,e-handel	bændel
4	ient	21	0.00020	21	0	patient,klient,ekspedient,kræftpatient,bistandsklient,hjertepatient,orient,klassekvotient,ambient,koefficient,intelligenskvotient,kvotient,recipient,gradient,parkinsonpatient,alzheimerpatient,differentialkvotient,postekspedient,terminalpatient,aids-patient,intervenient	
4	værk	88	0.00020	1	87	kværk	netværk,hærværk,kunstværk,håndværk,kraftværk,mesterværk,vandværk,atomkraftværk,kunsthåndværk,gasværk,bygningsværk,livsværk,embedsværk,elværk,vokseværk,teglværk,træværk,murværk,bolværk,varmeværk,plankeværk,hastværk,savværk,årsværk,underværk,makværk,fjernvarmeværk,rækværk,storværk,bindingsværk,bagværk,glasværk,stålvalseværk,dagsværk,stålværk,tovværk,korværk,blændværk,urværk,fæstningsværk,fletværk,pragtværk,standardværk,tobindsværk,elektricitetsværk,pelsværk,billedværk,udenværk,bygværk,hejseværk,gitterværk,tærskeværk,digterværk,isværk,galmandsværk,samleværk,regelværk,stokværk,narreværk,kalkværk,stemmeværk,gætteværk,tælleværk,bjergværk,drivværk,valseværk,bygningshåndværk,løvværk,tagværk,slagværk,sluseværk,åndsværk,tømmerværk,tømrerhåndværk,hæmværk,pindeværk,slyngværk,ristværk,a-kraftværk,kraft-varme-værk,trådværk,trisseværk,legeværk,knuseværk,gråværk,sprinkelværk,bjælkeværk
4	stem	30	0.00020	0	30		system,styresystem,økosystem,solsystem,nervesystem,kvotesystem,centralnervesystem,alarmsystem,operativsystem,lydsystem,reolsystem,flerpartisystem,koordinatsystem,fastprissystem,talsystem,topartisystem,etpartisystem,modulsystem,tokammersystem,metersystem,skriftsystem,titalssystem,klippekortsystem,frontsystem,decimalsystem,totalssystem,etkammersystem,tolvtalssystem,decimalklassesystem,duodecimalsystem
4	bold	34	0.00019	34	0	fodbold,håndbold,kvindehåndbold,herrehåndbold,topfodbold,snebold,kastebold,dødbold,landsholdsfodbold,tennisbold,sætbold,fjerbold,rundbold,bordfodbold,badebold,returbold,indefodbold,boksebold,gadefodbold,stopbold,gummibold,hoppebold,andenbold,stikbold,støvbold,basketbold,langbold,pengefodbold,volleybold,netbold,slyngbold,proffodbold,dropbold,bruskbold	
4	nhed	80	0.00019	80	0	begivenhed,enhed,skønhed,beliggenhed,uvidenhed,bevågenhed,sjældenhed,beskedenhed,tilbageholdenhed,medlidenhed,velgørenhed,renhed,udholdenhed,beskaffenhed,imødekommenhed,fornødenhed,overbærenhed,ujævnhed,vedholdenhed,afholdenhed,fuldkommenhed,selvmedlidenhed,urenhed,forlegenhed,specialenhed,agtpågivenhed,eftergivenhed,løntilbageholdenhed,måleenhed,godgørenhed,veltalenhed,kristenhed,almenhed,særegenhed,nedladenhed,forudseenhed,møntenhed,uformåenhed,finhed,underlegenhed,opgivenhed,københavnerbegivenhed,påholdenhed,godtroenhed,ordholdenhed,enkeltbegivenhed,tilbageståenhed,pågåenhed,efterladenhed,gemenhed,uforståenhed,alvidenhed,påtrængenhed,pligtopfyldenhed,vægtenhed,jævnhed,mådeholdenhed,rettroenhed,rigsenhed,pseudobegivenhed,nærtagenhed,foderenhed,vejbeliggenhed,opfarenhed,umådeholdenhed,uformuenhed,forekommenhed,formåenhed,tilbagetrukkenhed,velbårenhed,uvornhed,fremfusenhed,mængdeenhed,tyndtflydenhed,sjælsrenhed,indladenhed,tyktflydenhed,nærgåenhed,typeenhed,gudsforgåenhed	
4	ænse	28	0.00019	28	0	grænse,landegrænse,aldersgrænse,spærregrænse,fattigdomsgrænse,kommunegrænse,smertegrænse,fartgrænse,hastighedsgrænse,bagatelgrænse,bygrænse,bundgrænse,promillegrænse,støjgrænse,overgrænse,sultegrænse,kvalmegrænse,trægrænse,sproggrænse,snegrænse,fiskerigrænse,undergrænse,søgrænse,toldgrænse,skovgrænse,landgrænse,tremilegrænse,takstgrænse	
4	reng	32	0.00019	32	0	dreng,streng,tøsedreng,skoledreng,gadedreng,navlestreng,gulddreng,moppedreng,trækkerdreng,spejderdreng,bondedreng,bydreng,flaskedreng,bolddreng,messedreng,skibsdreng,klokkestreng,hyrdedreng,stikirenddreng,kordreng,læredreng,dæksdreng,poppedreng,harpestreng,vogterdreng,skomagerdreng,buestreng,fireårsdreng,seksårsdreng,syvårsdreng,nasi goreng,g-streng	
4	ddel	74	0.00019	33	41	seddel,stemmeseddel,fyreseddel,bøddel,saddel,ønskeseddel,bestanddel,pengeseddel,lønseddel,løbeseddel,runddel,daddel,slutseddel,tøddel,lodseddel,puddel,huskeseddel,indlægsseddel,tusindkroneseddel,hundredkroneseddel,spiseseddel,smørrebrødsseddel,dosmerseddel,fyringsseddel,følgeseddel,passerseddel,tilgodeseddel,mærkeseddel,femhundredekroneseddel,pundseddel,halvtredskroneseddel,paddel,silkepuddel	middel,lægemiddel,virkemiddel,hjælpemiddel,transportmiddel,sprøjtemiddel,rusmiddel,levnedsmiddel,magtmiddel,betalingsmiddel,vaskemiddel,kommunikationsmiddel,produktionsmiddel,sødemiddel,læremiddel,bindemiddel,vidundermiddel,drivmiddel,slankemiddel,sovemiddel,blegemiddel,fødemiddel,skyllemiddel,befordringsmiddel,smøremiddel,næringsmiddel,universalmiddel,rensemiddel,træbeskyttelsesmiddel,værnemiddel,brækmiddel,slibemiddel,hævemiddel,meddelelsesmiddel,afspændingsmiddel,pletfjerningsmiddel,konsistensmiddel,disciplinarmiddel,flusmiddel,stråforkortelsesmiddel,hærdemiddel
4	ting	47	0.00019	26	21	marketing,småting,rating,mellemting,casting,dating,brugsting,rafting,biting,coating,headhunting,telemarketing,uting,cutting,skifting,petting,sparkstøtting,løfting,outing,rotting,fejlcasting,bodypainting,frosting,ankerkætting,tufting,shirting	folketing,sting,landsting,alting,lagting,storting,korssting,forsting,stikkesting,værneting,kædesting,lasting,knaphulssting,herredsting,risting,sidesting,hulsting,blindsting,heksesting,sømmesting,shirting
4	ærdi	31	0.00019	31	0	værdi,friværdi,markedsværdi,grænseværdi,lejeværdi,underholdningsværdi,grundværdi,signalværdi,merværdi,kursværdi,nytteværdi,symbolværdi,hæmatokritværdi,herlighedsværdi,brugsværdi,affektionsværdi,salgsværdi,brændværdi,middelværdi,tærskelværdi,talværdi,kontantværdi,realværdi,nyværdi,jordværdi,pH-værdi,genkøbsværdi,fuldværdi,k-værdi,nominalværdi,tilbagekøbsværdi	
4	unst	36	0.00018	36	0	kunst,billedkunst,samtidskunst,gunst,filmkunst,malerkunst,scenekunst,brugskunst,vandkunst,kogekunst,dunst,ugunst,fortællekunst,popkunst,skuespilkunst,tryllekunst,konceptkunst,bygningskunst,lægekunst,brunst,skrivekunst,balancekunst,digtekunst,bogtrykkerkunst,performancekunst,tegnekunst,billedhuggerkunst,tonekunst,fiduskunst,sortekunst,vævekunst,fægtekunst,multikunst,kortkunst,trommesalskunst,sortkunst	
4	emme	28	0.00018	26	2	stemme,klemme,tremme,gemme,sangstemme,erhvervsfremme,fortællerstemme,brevstemme,mandsstemme,solostemme,tøjklemme,basstemme,listestemme,tenorstemme,nejstemme,sopranstemme,fremme,jastemme,altstemme,fistelstemme,understemme,cykelklemme,overstemme,hårklemme,tordenstemme,stentorstemme	gemme,nemme
4	logi	161	0.00018	161	0	teknologi,ideologi,psykologi,økologi,biologi,teologi,trilogi,mytologi,antologi,genteknologi,arkæologi,sociologi,informationsteknologi,bioteknologi,antropologi,geologi,terminologi,kronologi,astrologi,fysiologi,datalogi,filologi,højteknologi,analogi,nanoteknologi,mikrobiologi,gynækologi,farmakologi,neurologi,kosmologi,robotteknologi,epidemiologi,molekylærbiologi,patologi,zoologi,etnologi,meteorologi,fænomenologi,immunologi,politologi,anæstesiologi,sexologi,kriminologi,radiologi,onkologi,ontologi,socialpsykologi,urologi,kardiologi,etymologi,udviklingspsykologi,reumatologi,numerologi,toksikologi,kinesiologi,eskimologi,typologi,kultursociologi,byøkologi,børnepsykologi,ætiologi,morfologi,socialantropologi,topologi,apologi,palæontologi,neuropsykologi,tetralogi,ornitologi,genealogi,dermatologi,neurofysiologi,egyptologi,dybdepsykologi,virologi,gerontologi,psykopatologi,histologi,oftalmologi,odontologi,metodologi,marinbiologi,allergologi,parapsykologi,grafologi,humanbiologi,metrologi,tautologi,symptomatologi,sprogpsykologi,etologi,bakteriologi,audiologi,gestaltpsykologi,cytologi,epistemologi,glaciologi,venerologi,seismologi,lavteknologi,eskatologi,mineralogi,laryngologi,assyriologi,sprogteknologi,folkeetymologi,fraseologi,havbiologi,zoofysiologi,hydrologi,fonologi,embryologi,dendrokronologi,frenologi,parasitologi,semiologi,entomologi,klimatologi,indologi,sinologi,parodontologi,gruppepsykologi,serologi,kristologi,kremlologi,dialektologi,runologi,teleologi,homologi,ernæringsfysiologi,otologi,oceanologi,kosmetologi,kulturantropologi,feminologi,bromatologi,geomorfologi,osteologi,immunbiologi,ufologi,eksperimentalpsykologi,vulkanologi,røntgenologi,gemmologi,petrologi,hippologi,futurologi,haplologi,iktyologi,aerologi,herpetologi,ikonologi,individualpsykologi,højhastighedsteknologi,limnologi,bryologi,geobiologi,karakterologi,molekylarbiologi,selenologi,dendrologi	
4	oved	55	0.00018	1	54	slangehoved	hoved,baghoved,overhoved,statsoverhoved,brohoved,sprænghoved,dødningehoved,hestehoved,rodehoved,familieoverhoved,brokkehoved,salathoved,æggehoved,kålhoved,brushoved,strubehoved,hvidkålshoved,skvadderhoved,blomkålshoved,fæhoved,snakkehoved,janushoved,brevhoved,torskehoved,barnehoved,vrøvlehoved,rødkålshoved,tossehoved,grødhoved,pibehoved,fjollehoved,hængehoved,fjumrehoved,tonehoved,hammerhoved,klynkehoved,oksehoved,sludrehoved,pylrehoved,smølehoved,bjælkehoved,nussehoved,pjokkehoved,skabilkenhoved,tudehoved,pjathoved,skabehoved,snøvlehoved,dummerhoved,kvajhoved,skærehoved,sidehoved,sjokkehoved,klummerhoved
4	anke	27	0.00018	27	0	tanke,mistanke,eftertanke,omtanke,banke,skranke,planke,bagtanke,flanke,vidneskranke,tvangstanke,redningsplanke,kongstanke,manke,ranke,strøtanke,vinranke,tågebanke,østersbanke,muslingebanke,fiskebanke,pusselanke,guldranke,humleranke,check-in-skranke,skybanke,flyvetanke	
4	skel	31	0.00017	27	4	forskel,muskel,tærskel,floskel,dørtærskel,lattermuskel,mavemuskel,lægmuskel,temperaturforskel,målforskel,smertetærskel,tolerancetærskel,benmuskel,armmuskel,gradsforskel,lukkemuskel,væsensforskel,ringmuskel,standsforskel,minuskel,majuskel,bugmuskel,rygmuskel,artsforskel,bøjemuskel,rangforskel,strækkemuskel	klasseskel,markskel,vandskel,grænseskel
4	nist	80	0.00017	80	0	pensionist,komponist,pianist,kommunist,organist,gnist,feminist,violinist,førtidspensionist,humanist,saxofonist,folkepensionist,motionist,tenorsaxofonist,receptionist,basunist,modernist,perfektionist,fløjtenist,impressionist,unionist,zionist,opportunist,altsaxofonist,invalidepensionist,kolonist,stalinist,ekspressionist,mandschauvinist,protagonist,domorganist,satanist,illusionist,vibrafonist,harpenist,kautionist,hornist,postmodernist,revisionist,kreationist,percussionist,sopransaxofonist,darwinist,leninist,hedonist,antagonist,klokkenist,ekshibitionist,chauvinist,pladderhumanist,barytonsaxofonist,maskinist,calvinist,telefonist,kolumnist,betonkommunist,isolationist,germanist,alpinist,onanist,evolutionist,trombonist,morfinist,romanist,protektionist,determinist,reduktionist,alderspensionist,lutenist,valdhornist,monist,selvpensionist,hellenist,latinist,versionist,vivisektionist,indeterminist,senmodernist,xylofonist,iranist	
4	spil	86	0.00017	0	86		udspil,skuespil,samspil,slutspil,computerspil,modspil,puslespil,grundspil,angrebsspil,efterspil,gæstespil,rollespil,festspil,kortspil,indspil,forsvarsspil,opspil,fodboldspil,boldspil,magtspil,sammenspil,brætspil,mellemspil,forspil,dobbeltspil,ordspil,klaverspil,lystspil,kontraspil,guitarspil,klokkespil,kammerspil,radiospil,underspil,skakspil,hasardspil,pyramidespil,pokerspil,krybbespil,hovedspil,hørespil,syngespil,lottospil,klumpspil,skyggespil,medspil,solospil,overspil,rænkespil,maskespil,krigsspil,positionsspil,lotterispil,slagspil,nulsumsspil,mummespil,skrabespil,andespil,fedtspil,singleudspil,minespil,stregspil,arkadespil,sørgespil,komediespil,dukkespil,keglespil,satyrspil,ludospil,strengespil,huskespil,vendespil,bobspil,ankerspil,djævlespil,falskspil,gangspil,ekstemporalspil,pilespil,gøglespil,vovespil,TV-spil,loppespil,memoryspil,rubatospil,damspil
4	lade	54	0.00017	54	0	plade,overflade,ballade,chokolade,nummerplade,flade,bordplade,marmelade,håndflade,sendeflade,vandoverflade,kogeplade,boglade,brugerflade,berøringsflade,remoulade,programflade,brudflade,grammofonplade,kontaktflade,spånplade,spilleplade,grænseflade,roulade,farvelade,brugergrænseflade,snitflade,pålægschokolade,printplade,staklade,singleplade,perleplade,morgenflade,vægflade,blodplade,aftenflade,flødechokolade,krydsfinerplade,orangemarmelade,grundflade,sideflade,tyggeflade,finerplade,kogechokolade,laminatplade,dessertchokolade,kegleflade,prægeplade,akkolade,ingefærmarmelade,LP-plade,strygeflade,parerplade,slidflade	
4	omst	62	0.00016	62	0	blomst,overenskomst,indkomst,ankomst,overførselsindkomst,forekomst,hjemkomst,herkomst,sammenkomst,velkomst,fremkomst,genkomst,mellemkomst,sommerblomst,tilbagekomst,årsindkomst,hyldeblomst,opkomst,adkomst,tilsynekomst,klokkeblomst,bruttoindkomst,mellemindkomst,realindkomst,kornblomst,bekomst,stedmoderblomst,tilskadekomst,lavindkomst,nationalindkomst,tilkomst,isblomst,ærteblomst,socialindkomst,smørblomst,kirsebærblomst,nedkomst,passionsblomst,bruttofaktorindkomst,bortkomst,evighedsblomst,kurvblomst,højindkomst,hawaiiblomst,kamilleblomst,merindkomst,jasminblomst,fløjlsblomst,porcelænsblomst,flueblomst,læbeblomst,skærmblomst,nulindkomst,gæslingeblomst,tøffelblomst,udkomst,hjerteblomst,skiveblomst,B-indkomst,skalaindkomst,A-indkomst,tilstedekomst	
4	rist	61	0.00016	58	3	turist,terrorist,jurist,frist,guitarist,tidsfrist,brist,dokumentarist,prokurist,humorist,mejerist,marineinfanterist,kolorist,antikrist,vrist,kontorist,ekvilibrist,naturist,futurist,livrist,infanterist,kommunikationsbrist,karakterbrist,grillrist,ankefrist,mytterist,artillerist,seminarist,leadguitarist,korist,folklorist,militarist,optometrist,havarist,monetarist,rygsæksturist,utilitarist,florist,antimilitarist,purist,økoturist,færist,galgenfrist,behaviorist,kommunitarist,kavalerist,manicurist,akvarist,skraberist,tegningsfrist,tenorist,historist,partikularist,empirist,podagrist,delirist,verist,rigorist	brist,kommunikationsbrist,karakterbrist
4	gift	35	0.00016	35	0	udgift,afgift,renteudgift,sprøjtegift,tilgift,voldgift,miljøafgift,vægtafgift,kørselsafgift,modgift,arveafgift,medgift,punktafgift,transportudgift,miljøgift,gaveafgift,stempelafgift,boafgift,rottegift,studieafgift,kontrolafgift,importafgift,indgift,cellegift,omsætningsafgift,enkeltudgift,rusgift,grundafgift,værdiafgift,merværdiafgift,forgift,pilegift,garderobeafgift,CO₂-afgift,p-afgift	
4	side	44	0.00016	44	0	hjemmeside,forside,bagside,inderside,slagside,skyggeside,yderside,underside,langside,bredside,offside,sydside,plusside,helside,overside,venstreside,højreside,solside,sportsside,søside,minusside,indtægtsside,ringside,udgiftsside,positivside,skibsside,vrangside,spindeside,landside,natside,midterside,startside,negativside,flæskeside,læside,retside,normalside,sværdside,vindside,mandsside,svartside,udside,debetside,smalside	
4	utik	22	0.00016	22	0	butik,genbrugsbutik,tøjbutik,dagligvarebutik,netbutik,gårdbutik,købmandsbutik,discountbutik,rodebutik,slagterbutik,nærbutik,detailbutik,kædebutik,fødevarebutik,onlinebutik,bagbutik,hermeneutik,telebutik,juvelerbutik,astronautik,propædeutik,terapeutik	
4	ltur	31	0.00016	31	0	kultur,cykeltur,sejltur,madkultur,subkultur,virksomhedskultur,finkultur,popkultur,modkultur,børnekultur,massekultur,folkekultur,akvakultur,bakteriekultur,renkultur,begivenhedskultur,køkultur,undergrundskultur,forbrugerkultur,singlekultur,machokultur,storbykultur,nulfejlskultur,krænkelseskultur,mayakultur,vævskultur,gærkultur,inuitkultur,inkakultur,damkultur,agrikultur	
4	uger	30	0.00015	30	0	forbruger,bruger,misbruger,stofmisbruger,støvsuger,storforbruger,stemmesluger,slutbruger,sprogbruger,landbruger,alkoholmisbruger,dambruger,slamsuger,jordbruger,superbruger,blodsuger,agerbruger,strømsluger,suger,myresluger,skallesluger,pengepuger,ildsluger,blandingsmisbruger,sandsuger,sabelsluger,børnemisbruger,udsuger,havebruger,puger	
4	kamp	41	0.00015	41	0	valgkamp,landskamp,hjemmekamp,fodboldkamp,kvalifikationskamp,træningskamp,udekamp,returkamp,kulturkamp,testkamp,pokalkamp,ligakamp,nærkamp,klassekamp,frihedskamp,åbningskamp,gadekamp,slåskamp,håndboldkamp,titelkamp,ildkamp,omkamp,kvindekamp,boksekamp,tvekamp,slutkamp,divisionskamp,dødskamp,skæbnekamp,playoffkamp,femkamp,brydekamp,ishockeykamp,vandkamp,revanchekamp,gladiatorkamp,tikamp,sneboldkamp,pudekamp,jakobskamp,væddekamp	
4	ehus	39	0.00015	0	39		sygehus,kongehus,rækkehus,varehus,modehus,centralsygehus,stuehus,feriehus,mediehus,enfamiliehus,typehus,dukkehus,hønsehus,legehus,kernehus,spisehus,gæstehus,bondehus,slagtehus,lavprisvarehus,galehus,styrehus,sneglehus,frysehus,hundehus,bjælkehus,horehus,bådehus,fyrstehus,prøvehus,kølehus,gårdhavehus,klyngehus,kædehus,tofamiliehus,huggehus,sporehus,terrassehus,flerfamiliehus
4	ører	43	0.00015	43	0	ordfører,oprører,kører,fører,tilhører,anfører,forretningsfører,hører,landsretssagfører,sagfører,bannerfører,knallertkører,spilfører,værkfører,skibsfører,forfører,togfører,lokofører,bortfører,hærfører,hundefører,velgører,højesteretssagfører,kranfører,dukkefører,testkører,rejsefører,truckfører,rallykører,ungdomsoprører,blødgører,traktorfører,gruppefører,bådfører,elektrofører,holdfører,fremmedfører,gaffeltruckfører,promillekører,undergører,rambukfører,smører,skadegører	
4	fald	51	0.00015	0	51		affald,dødsfald,udfald,overfald,forfald,prisfald,kursfald,bifald,anfald,vandfald,frafald,indfald,sammenfald,tonefald,tilbagefald,knæfald,atomaffald,bortfald,syndefald,snefald,lysindfald,angstanfald,raserianfald,tæppefald,bundfald,tiltalefrafald,nedfald,mandefald,løvfald,kemikalieaffald,krampeanfald,hosteanfald,stormfald,møgfald,henfald,giftaffald,nødsfald,messefald,rullefald,solindfald,ejefald,mørkefald,fremfald,genstandsfald,nævnefald,underfald,klinkefald,afhængighedsfald,solfald,jordfald,hensynsfald
4	iver	47	0.00015	47	0	arbejdsgiver,rådgiver,socialrådgiver,sangskriver,giver,skriver,lovgiver,udgiver,bankrådgiver,trediver,långiver,maldiver,driver,underskriver,beskriver,brevskriver,investeringsrådgiver,tilbudsgiver,klummeskriver,angiver,receiver,spareiver,formgiver,stiver,historieskriver,krønikeskriver,fartskriver,reformiver,gæstgiver,opgiver,kunderådgiver,kodriver,familierådgiver,dagdriver,udebliver,køkkenskriver,river,sorenskriver,djævleuddriver,gengiver,lysgiver,livgiver,kortgiver,vinkelskriver,trosiver,maskinskriver,tjenesteiver	
4	øtte	21	0.00015	21	0	støtte,statsstøtte,bøtte,boligstøtte,mælkebøtte,nakkestøtte,kolbøtte,mediestøtte,skamstøtte,sponsorstøtte,samfundsstøtte,studiestøtte,rygstøtte,stenstøtte,skraldebøtte,saltstøtte,fyldebøtte,bogstøtte,billedstøtte,skarnbøtte,vrøvlebøtte	
4	ativ	41	0.00015	13	28	superlativ,imperativ,akkusativ,nominativ,dativ,indikativ,ablativ,vokativ,komparativ,lokativ,frikativ,optativ,narrativ	initiativ,alternativ,negativ,stativ,regulativ,kooperativ,klatrestativ,nodestativ,recitativ,gyngestativ,tørrestativ,præservativ,imperativ,prærogativ,demonstrativ,palliativ,portativ,appellativ,kausativ,situativ,relativ,sikkativ,sedativ,fiksativ,laksativ,prædikativ,derivativ,interrogativ
4	prog	44	0.00014	0	44		sprog,ordsprog,kropssprog,fremmedsprog,formsprog,billedsprog,fagsprog,skriftsprog,tegnsprog,talesprog,originalsprog,andetsprog,hovedsprog,valgsprog,programmeringssprog,nysprog,dagligsprog,arbejdssprog,frisprog,nationalsprog,kunstsprog,nabosprog,kancellisprog,fingersprog,rigssprog,regionalsprog,standardsprog,ursprog,grundsprog,klarsprog,omgangssprog,almensprog,barnesprog,plansprog,kreolsprog,modersprog,vulgærsprog,metasprog,målsprog,klikesprog,gestussprog,pidginsprog,objektsprog,udgangssprog
4	rant	28	0.00014	27	1	restaurant,demonstrant,garant,immigrant,migrant,aspirant,laborant,emigrant,fiskerestaurant,deodorant,ignorant,registrant,hospitalslaborant,fortovsrestaurant,figurant,kvadrant,warrant,antiperspirant,amarant,priskurant,ministrant,histolaborant,hydrant,obskurant,prænumerant,kontokurant,spirant	warrant
4	form	47	0.00014	47	0	reform,platform,skattereform,uniform,kommunalreform,topform,styreform,folkeskolereform,gymnasiereform,storform,boreplatform,kampform,boform,dagsform,pasform,skoleuniform,springform,politiuniform,støbeform,landboreform,kortform,bageform,kanonform,pulverform,gallauniform,blandingsform,blandform,tillægsform,bøjningsform,kageform,kloroform,staveform,tilstandsform,bydeform,hesteskoform,væskeform,navneform,handleform,lovform,generalsuniform,lideform,kaptajnsuniform,kummerform,opslagsform,tempusform,jodoform,præsensform	
4	kade	41	0.00014	41	0	skade,blokade,barrikade,hjerneskade,knæskade,arbejdsskade,rokade,personskade,kaskade,vandskade,rygskade,arkade,kavalkade,regeringsrokade,ministerrokade,høreskade,cikade,brandskade,stormskade,fugtskade,frostskade,museskade,strandskade,følgeskade,brokade,epiduralblokade,lyskenskade,idrætsskade,sætningsskade,selvskade,dekade,skovskade,maskinskade,tornskade,totalskade,solskade,haglskade,skumcikade,kræftskade,gæstebudsskade,krokade	
4	rsel	61	0.00014	55	6	advarsel,kørsel,opførsel,barsel,overførsel,indkørsel,rundkørsel,spirituskørsel,spritkørsel,påkørsel,tilførsel,afkørsel,nedkørsel,indførsel,udkørsel,pengeoverførsel,testkørsel,frakørsel,bykørsel,prøvekørsel,overkørsel,gennemkørsel,tilkørsel,omkørsel,udførsel,samkørsel,opkørsel,tilbageførsel,promillekørsel,gennemførsel,vanvidskørsel,dødskørsel,motorvejskørsel,dataoverførsel,venstrekørsel,bortførsel,højrekørsel,genindførsel,studenterkørsel,personpåkørsel,slalomkørsel,anførsel,meritoverførsel,smitteoverførsel,bortkørsel,fremførsel,vidneførsel,kortegekørsel,ærindekørsel,underkørsel,glatkørsel,hjemførsel,ilandkørsel,rådførsel,pendulkørsel	varsel,forvarsel,strejkevarsel,stormvarsel,urovarsel,stævnevarsel
4	ikel	23	0.00014	22	1	artikel,matrikel,partikel,fennikel,testikel,elementarpartikel,eksportartikel,ventrikel,toiletartikel,trosartikel,antipartikel,aurikel,bitestikel,kernepartikel,alfapartikel,follikel,spidsartikel,sanikel,betapartikel,konventikel,perpendikel,fascikel	vehikel
4	olig	22	0.00014	22	0	bolig,ejerbolig,andelsbolig,ældrebolig,plejebolig,lejebolig,ungdomsbolig,privatbolig,embedsbolig,fritidsbolig,tjenestebolig,studiebolig,seniorbolig,æresbolig,tagbolig,fribolig,funktionærbolig,forpagterbolig,gartnerbolig,kollektivbolig,nødbolig,fleksbolig	
4	ærke	53	0.00014	7	46	mærke,sanglærke,lærke,lommelærke,skovmærke,toplærke,bomlærke	mærke,varemærke,frimærke,mindesmærke,bilmærke,pejlemærke,klistermærke,julemærke,adelsmærke,miljømærke,rygmærke,energimærke,kendemærke,vandmærke,bogmærke,modermærke,bomærke,brændemærke,landemærke,sømærke,prismærke,idrætsmærke,strækmærke,samlingsmærke,kendingsmærke,lurmærke,premiummærke,kradsemærke,kainsmærke,landmærke,våbenmærke,stempelmærke,sugemærke,firmamærke,spillemærke,klæbemærke,enemærke,identitetsmærke,øremærke,fabriksmærke,manilamærke,tokronersfrimærke,tiøresfrimærke,særmærke,skelnemærke,gradsmærke
4	læde	24	0.00014	10	14	glæde,livsglæde,arbejdsglæde,slæde,køreglæde,hundeslæde,selvglæde,bobslæde,skaberglæde,samleglæde	tørklæde,klæde,håndklæde,halstørklæde,forklæde,lommetørklæde,silketørklæde,lændeklæde,partisantørklæde,papirlommetørklæde,frottéhåndklæde,hovedklæde,pyntelommetørklæde,kittelforklæde
4	sted	60	0.00014	1	59	ørsted	værksted,spillested,mødested,hjemsted,spisested,værested,gerningssted,opholdssted,ståsted,fristed,valgsted,bosted,gravsted,samlingssted,stoppested,tilholdssted,ulykkessted,landsted,busstoppested,levested,husmandssted,autoværksted,arnested,websted,fødested,skjulested,ildsted,bæltested,vadested,gemmested,tilflugtssted,åsted,hvilested,brandsted,udsted,netsted,traktørsted,tingsted,skriftsted,tjenestested,kursted,voksested,findested,skriveværksted,voldsted,fundsted,malerværksted,ynglested,insted,rettersted,toldsted,rastested,chatsted,trykkested,tappested,postindleveringssted,dødssted,postafhentningssted,fyrsted
4	amme	27	0.00014	27	0	ramme,stamme,flamme,skramme,strafferamme,træstamme,tidsramme,referenceramme,lønramme,indianerstamme,togstamme,målramme,kugleramme,klamme,låneramme,stikflamme,faldstamme,ratstamme,beløbsramme,madamme,skifteramme,hæfteklamme,svejseflamme,diasramme,tuborgklamme,skæreflamme,blindramme	
4	ejse	33	0.00013	33	0	rejse,afrejse,rundrejse,udlandsrejse,charterrejse,indrejse,bryllupsrejse,studierejse,udrejse,pakkerejse,tidsrejse,jomfrurejse,gennemrejse,udenlandsrejse,tjenesterejse,grupperejse,dagsrejse,blåmejse,sprogrejse,bortrejse,selskabsrejse,mejse,spætmejse,billigrejse,sumpmejse,sortmejse,pungmejse,topmejse,fyrremejse,dagrejse,henrejse,gråmejse,lapmejse	
4	drag	26	0.00013	0	26		bidrag,foredrag,fradrag,uddrag,afdrag,åndedrag,bedrag,skattefradrag,arbejdsmarkedsbidrag,selvbedrag,børnebidrag,bundfradrag,højdedrag,opdrag,personfradrag,bakkedrag,sammendrag,kørselsfradrag,underholdsbidrag,engdrag,synsbedrag,nakkedrag,sansebedrag,am-bidrag,AUD-bidrag,ATP-bidrag
4	oman	35	0.00013	35	0	roman,narkoman,kriminalroman,ludoman,pyroman,kærlighedsroman,samtidsroman,nøgleroman,tryghedsnarkoman,slægtsroman,dannelsesroman,stiknarkoman,knaldroman,udviklingsroman,murstensroman,generationsroman,detektivroman,kollektivroman,lægeroman,ottoman,nymfoman,dokumentarroman,fantasyroman,kleptoman,mytoman,føljetonroman,trivialroman,skælmeroman,erotoman,biblioman,eufoman,jegroman,megaloman,science fiction-roman,tendensroman	
4	geri	45	0.00013	0	45		byggeri,bryggeri,bedrageri,nybyggeri,boligbyggeri,bageri,mikrobryggeri,lingeri,røgeri,orangeri,tiggeri,menageri,dyrplageri,prestigebyggeri,mundhuggeri,bondefangeri,plattenslageri,kurmageri,spøgeri,ligemageri,socialbedrageri,plageri,rugeri,elementbyggeri,klamphuggeri,pindehuggeri,søvngængeri,løsgængeri,færgeri,skomageri,stenhuggeri,montagebyggeri,kogeri,silderøgeri,selvbyggeri,hjemmebageri,drøvtyggeri,rebslageri,jageri,pandekageri,buntmageri,saddelmageri,posekiggeri,vindmageri,strygeri
4	bane	55	0.00013	55	0	hjemmebane,jernbane,udebane,midtbane,golfbane,letbane,fodboldbane,vejbane,løbebane,kørebane,landingsbane,glidebane,rutsjebane,skøjtebane,tennisbane,boldbane,travbane,væddeløbsbane,skydebane,undergrundsbane,racerbane,privatbane,godsbane,vognbane,ridebane,startbane,galopbane,kortbane,svævebane,busbane,forhindringsbane,togbane,langbane,grusbane,bowlingbane,inderbane,nærbane,tunnelbane,højbane,tankebane,reberbane,slidbane,gokartbane,yderbane,midterbane,keglebane,skateboardbane,tovbane,bjergbane,cindersbane,forbryderbane,vildtbane,attenhullersbane,S-bane,nihullersbane	
4	stik	71	0.00013	46	25	statistik,journalistik,gymnastik,mystik,logistik,karakteristik,plastik,akustik,elastik,tændstik,diagnostik,gestik,lingvistik,svovlstik,skruestik,trommestik,sportsjournalistik,springgymnastik,fantastik,essayistik,ledighedsstatistik,skolastik,redskabsgymnastik,stilistik,sociolingvistik,tandstik,folkloristik,datalingvistik,ørestik,germanistik,petitjournalistik,revolverjournalistik,kriminalistik,novellistik,slavistik,ballistik,psykolingvistik,gonzojournalistik,romanistik,anglistik,gravstik,floristik,galvanoplastik,domestik,heuristik,rideelastik	bestik,spadestik,knivstik,kobberstik,trumfstik,solstik,nålestik,myggestik,indstik,overstik,bistik,sidestik,spisebestik,stålstik,halvstik,hunstik,jackstik,bananstik,hanstik,fordelerstik,loppestik,scartstik,USB-stik,understik,tegnebestik
4	leri	58	0.00013	4	54	selleri,bladselleri,blegselleri,knoldselleri	maleri,galleri,hykleri,persongalleri,drilleri,artilleri,oliemaleri,kalkmaleri,hæleri,trylleri,smugleri,vægmaleri,skønmaleri,kunstgalleri,destilleri,kavaleri,føleri,hulemaleri,praleri,fifleri,fjolleri,mølleri,juleri,skribleri,grubleri,smøleri,surmuleri,billedgalleri,gøgleri,kæleri,betleri,pilleri,freskomaleri,lefleri,kævleri,miniaturemaleri,svindleri,klatmaleri,kogleri,anegalleri,genremaleri,djævleri,taskenspilleri,typegalleri,trommesalsmaleri,stikleri,skumleri,krakileri,monumentalmaleri,vrøvleri,plafondmaleri,gørtleri,fidusmaleri,skylleri
4	brud	42	0.00013	3	39	barnebrud,luciabrud,sølvbrud	indbrud,gennembrud,sammenbrud,udbrud,opbrud,løftebrud,skybrud,nybrud,vulkanudbrud,frembrud,lovbrud,nedbrud,kraniebrud,skibbrud,tøbrud,hovedbrud,knoglebrud,vredesudbrud,tillidsbrud,benbrud,nervesammenbrud,stenbrud,grundlovsbrud,kontraktbrud,kalkbrud,monopolbrud,regelbrud,stilbrud,raseriudbrud,soloudbrud,traktatbrud,bækkenbrud,digebrud,afbrud,retsbrud,granitbrud,vårbrud,anbrud,tandbrud
4	ærer	48	0.00013	48	0	lærer,skolelærer,gymnasielærer,folkeskolelærer,klasselærer,bærer,overlærer,kørelærer,dansklærer,faglærer,matematiklærer,idrætslærer,gæstelærer,vandbærer,fanebærer,timelærer,bagagebærer,kulturbærer,sproglærer,fysiklærer,smittebærer,tysklærer,gymnastiklærer,huslærer,førstelærer,hjælpelærer,billedskærer,sløjdlærer,støttelærer,træskærer,kontaktlærer,indvandrerlærer,regnelærer,tilskærer,spillelærer,ligbærer,talelærer,meritlærer,brødskærer,praktiklærer,døvelærer,støvbærer,glasskærer,skrivelærer,osteskærer,klovbeskærer,forskærer,tale-høre-lærer	
4	akke	51	0.00013	51	0	pakke,bakke,nakke,jakke,madpakke,frakke,hjælpepakke,vækstpakke,læderjakke,hakke,vindjakke,lovpakke,krisepakke,regnfrakke,overfrakke,dynejakke,indbakke,kælkebakke,galgebakke,æggebakke,tweedjakke,dunjakke,foliebakke,kattebakke,båtnakke,fejebakke,skihopbakke,fleecejakke,tyrenakke,stivnakke,kindbakke,præsenterbakke,bremsebakke,diplomatfrakke,smakke,småpakke,hopbakke,skødefrakke,brødbakke,værdipakke,udbakke,figurfrakke,tåbenakke,overgangsjakke,kampjakke,teddybearfrakke,tyvestykspakke,altvejrsjakke,flaskebakke,tistykspakke,softshelljakke	
4	yrke	28	0.00013	28	0	styrke,arbejdsstyrke,specialstyrke,fredsstyrke,viljestyrke,råstyrke,lydstyrke,lysstyrke,udrykningsstyrke,vindstyrke,muskelstyrke,slidstyrke,elitestyrke,orkanstyrke,strømstyrke,indsatsstyrke,stormstyrke,slagstyrke,karakterstyrke,sikringsstyrke,brudstyrke,beredskabsstyrke,synsstyrke,sjælsstyrke,kropsstyrke,rivstyrke,åndsstyrke,strækstyrke	
4	stol	66	0.00013	66	0	domstol,pistol,talerstol,kørestol,lænestol,maskinpistol,prædikestol,chefstol,direktørstol,liggestol,kontorstol,rullestol,barnestol,klapstol,barstol,hovedstol,autostol,gyngestol,skriftestol,tjenestepistol,folkedomstol,tronstol,sækkestol,pavestol,luftpistol,kurvestol,vandpistol,instruktørstol,særdomstol,gaspistol,guldstol,legetøjspistol,sømpistol,lærestol,armstol,strømpistol,boltpistol,øreklapstol,bispestol,bærestol,splatterpistol,skalstol,stabelstol,limpistol,sprøjtepistol,wienerstol,safaristol,pindestol,gåstol,voldgiftsdomstol,flugtstol,drejestol,elkørestol,vævestol,elevatorstol,chesterfieldstol,gangstol,tremmestol,rokkestol,rottingstol,hæftepistol,windsorstol,malepistol,bådsmandsstol,dæksstol,nodestol	
4	chef	33	0.00012	33	0	topchef,kontorchef,koncernchef,departementschef,kommunikationschef,souschef,salgschef,teaterchef,køkkenchef,forsvarschef,udviklingschef,turistchef,personalechef,stabschef,programchef,produktchef,butikschef,socialchef,statschef,kompagnichef,maskinchef,brandchef,hofchef,kabinetschef,laboratoriechef,logistikchef,lagerchef,protokolchef,receptionschef,seniorchef,værnschef,eskadrechef,juniorchef	
4	inje	38	0.00012	38	0	linje,retningslinje,bundlinje,sidelinje,skillelinje,frontlinje,kystlinje,skudlinje,baglinje,tidslinje,mållinje,midterlinje,sigtelinje,brudlinje,fugleflugtslinje,pinje,luftlinje,demarkationslinje,byggelinje,ganglinje,datolinje,fødelinje,grundlinje,verselinje,diskretionslinje,bikinilinje,bølgelinje,tallinje,mandslinje,globelinje,vigelinje,vaterlinje,skrålinje,lodlinje,nullinje,ildlinje,siksaklinje,horisontallinje	
4	graf	48	0.00012	48	0	biograf,fotograf,paragraf,koreograf,scenograf,autograf,formålsparagraf,typograf,filmfotograf,geograf,etnograf,radiograf,telegraf,seismograf,amatørfotograf,gummiparagraf,demograf,litograf,kartograf,oceanograf,fonograf,stenograf,kanonfotograf,pornograf,ordenshistoriograf,paparazzofotograf,historiograf,løfteparagraf,kryptograf,leksikograf,bibliograf,kalligraf,serigraf,spektrograf,topograf,epigraf,homograf,xylograf,reprograf,digraf,palæograf,hektograf,drive-in-biograf,elektrokardiograf,kardiograf,oscillograf,termograf,barograf	
4	ator	100	0.00012	100	0	kommentator,diktator,senator,kurator,elevator,koordinator,indikator,administrator,katalysator,radiator,generator,respirator,illustrator,rollator,konservator,inspirator,ækvator,gladiator,organisator,reformator,simulator,ventilator,alligator,triumfator,kommunikator,animator,accelerator,visitator,agitator,eksaminator,stabilisator,vibrator,karburator,transformator,detonator,regulator,kondensator,taksator,moderator,manipulator,likvidator,akkumulator,emulgator,improvisator,kolonisator,inhalator,totalisator,operator,donator,innovator,imitator,registrator,inkassator,defibrillator,konspirator,kultivator,eksperimentator,makulator,isolator,testator,evaluator,stimulator,vareelevator,prokurator,observator,restaurator,imperator,recitator,popularisator,duplikator,oscillator,usurpator,plagiator,kalkulator,informator,applikator,separator,kompensator,analysator,tabulator,infiltrator,kommutator,mediator,evaporator,facilitator,destillator,filtrator,demodulator,eskalator,demonstrator,fundator,multiplikator,regenerator,orator,identifikator,paternosterelevator,versifikator,deklamator,laborator,kompilator	
4	møde	35	0.00012	0	35		topmøde,pressemøde,årsmøde,retsmøde,borgermøde,fremmøde,folkemøde,vælgermøde,stormøde,ministermøde,forældremøde,orienteringsmøde,stævnemøde,rådsmøde,delegeretmøde,hastemøde,redaktionsmøde,telefonmøde,frokostmøde,bønnemøde,formøde,friluftsmøde,plenarmøde,introduktionsmøde,infomøde,videomøde,lærermøde,rigsmøde,heldagsmøde,summemøde,plenummøde,todagesmøde,internatmøde,gå hjem-møde,flerdagesmøde
4	ilde	23	0.00011	12	11	kilde,indtægtskilde,lyskilde,tilde,smittekilde,oliekilde,fejlkilde,støjkilde,helligkilde,landgilde,hjælpekilde,snilde	gilde,rejsegilde,rivegilde,sammenskudsgilde,torskegilde,drikkegilde,andendagsgilde,krebsegilde,drukgilde,høstgilde,snilde
4	etid	41	0.00011	41	0	ventetid,spilletid,levetid,skoletid,lukketid,krisetid,studietid,vikingetid,løbetid,juletid,sendetid,myldretid,taletid,læretid,sengetid,middellevetid,spørgetid,spisetid,mødetid,liggetid,agurketid,flyvetid,træffetid,hviletid,nattetid,spærretid,yngletid,tjenestetid,kirketid,fastetid,klunketid,ulvetid,tørretid,nedetid,oppetid,zonetid,ramletid,kælvetid,slagtetid,voksetid,sværmetid	
4	olog	105	0.00011	105	0	psykolog,arkæolog,biolog,sociolog,teolog,antropolog,monolog,meteorolog,geolog,nekrolog,prolog,politolog,sexolog,økolog,ideolog,ornitolog,astrolog,zoolog,skolepsykolog,gynækolog,neurolog,kriminolog,kultursociolog,etnolog,børnepsykolog,filolog,kosmetolog,chefideolog,palæontolog,havbiolog,krisepsykolog,mikrobiolog,patolog,klimatolog,radiolog,religionssociolog,marinbiolog,neuropsykolog,fysiolog,egyptolog,grafolog,glaciolog,bromatolog,teknolog,socialantropolog,sinolog,immunolog,toksikolog,virolog,dermatolog,vildtbiolog,entomolog,fænomenolog,udviklingspsykolog,kinesiolog,seismolog,reumatolog,bakteriolog,kardiolog,runolog,dybdepsykolog,gemmolog,neurofysiolog,ernæringsfysiolog,bioteknolog,kremlolog,allergolog,humanbiolog,gestaltpsykolog,ufolog,nanoteknolog,mytolog,indolog,sprogteknolog,hippolog,onkolog,metrolog,terminolog,laryngolog,futurolog,frenolog,odontolog,otolog,farmakolog,herpetolog,etolog,epidemiolog,urolog,dialektolog,anæstesiolog,sprogpsykolog,gruppepsykolog,assyriolog,histolog,gerontolog,eskimolog,oftalmolog,limnolog,serolog,vulkanolog,dendrolog,venerolog,geobiolog,oceanolog,numerolog	
4	plan	42	0.00011	30	12	lokalplan,handlingsplan,landsplan,køreplan,tidsplan,redningsplan,helhedsplan,handleplan,fremtidsplan,masterplan,læseplan,vagtplan,læreplan,byplan,regionplan,slagplan,nødplan,grundplan,kostplan,femårsplan,fartplan,timeplan,bordplan,togplan,sommerkøreplan,langtidsplan,perspektivplan,fredningsplan,regionalplan,situationsplan	landsplan,verdensplan,gadeplan,topplan,skråplan,stueplan,amatørplan,jordplan,biplan,monoplan,bæreplan,hydroplan
4	ngel	21	0.00011	18	3	mangel,engel,stængel,slyngel,triangel,iltmangel,skytsengel,yngel,ærkeengel,blodmangel,vitaminmangel,lakseyngel,basunengel,materialemangel,svingel,bengel,råstofmangel,tidmangel	tingeltangel,rektangel,dingeldangel
4	gger	70	0.00010	68	2	indbygger,grundlægger,billedhugger,forlægger,overligger,tigger,brygger,planlægger,kigger,blogger,brobygger,nybygger,byplanlægger,tilrettelægger,aflægger,spækhugger,skibsbygger,bådebygger,stenhugger,fastligger,skovhugger,drøvtygger,jogger,ødelægger,klamphugger,brolægger,violinbygger,selvbygger,orgelbygger,fuldrigger,programlægger,landligger,autoophugger,minelægger,sjagger,vindueskigger,møllebygger,rørlægger,medbygger,ophugger,brændehugger,udlægger,rigger,inrigger,maskinbygger,udligger,æglægger,mikrobrygger,outrigger,bogtilrettelægger,teltligger,kabellægger,pindehugger,forligger,mineudlægger,videoblogger,kartoffellægger,jigger,posekigger,lugger,udrigger,vlogger,sengeforligger,underligger,bilægger,logger,landsplanlægger,pligthugger	pilekogger,kogger
4	rter	30	0.00010	17	13	reporter,hjerter,starter,frankfurter,transporter,hjertestarter,supporter,morter,porter,konverter,middelfarter,kickstarter,opvarter,selvstarter,afkorter,beværter,stråforkorter	kvarter,hovedkvarter,charter,frikvarter,villakvarter,slumkvarter,latinerkvarter,spisefrikvarter,forstadskvarter,fattigkvarter,rabarberkvarter,timecharter,natkvarter
4	rafi	64	0.00010	57	7	fotografi,biografi,scenografi,koreografi,geografi,selvbiografi,pornografi,litografi,demografi,monografi,mammografi,typografi,bibliografi,topografi,etnografi,ikonografi,kalligrafi,diskografi,serigrafi,ortografi,telegrafi,leksikografi,oceanografi,holografi,autobiografi,kulturgeografi,kartografi,krystallografi,kryptografi,stenografi,hagiografi,historiografi,elektrokardiografi,termografi,tomografi,elektroencefalografi,biogeografi,radiografi,xylografi,homografi,xerografi,hydrografi,ideografi,metallografi,reprografi,regionalgeografi,kardiografi,røntgenografi,zinkografi,selenografi,gaskromatografi,erhvervsgeografi,encefalografi,kinematografi,kemigrafi,palæografi,kromatografi	fotografi,litografi,mammografi,serigrafi,xylografi,pasfotografi,zinkografi
4	ktiv	20	0.00010	4	16	aktiv,detektiv,privatdetektiv,konjunktiv	perspektiv,aktiv,direktiv,kollektiv,objektiv,adjektiv,korrektiv,fugleperspektiv,landsplandirektiv,helikopterperspektiv,frøperspektiv,centralperspektiv,produktionskollektiv,teleobjektiv,zoomobjektiv,participialadjektiv
4	læge	28	0.00010	28	0	overlæge,tandlæge,speciallæge,dyrlæge,embedslæge,reservelæge,vagtlæge,cheflæge,øjenlæge,børnelæge,livlæge,ørelæge,skolelæge,kræftlæge,stadslæge,stabslæge,huslæge,naturlæge,distriktslæge,kredslæge,skoletandlæge,stadsdyrlæge,natlæge,generallæge,retslæge,barfodslæge,underlæge,øre-næse-hals-læge	
4	ente	21	0.00010	17	4	rente,mente,livrente,realrente,dente,glente,strafrente,lånerente,ågerrente,morarente,byggerente,overrente,entente,detente,stente,hybente,dag til dag-rente	testamente,sakramente,regimente,livstestamente
4	llet	20	0.00010	20	0	billet,ballet,flybillet,returbillet,enkeltbillet,fribillet,paillet,skattebillet,pladsbillet,bullet,endagsbillet,voksenbillet,jazzballet,entrébillet,tillægsbillet,pellet,dobbeltbillet,timebillet,barnebillet,andenklassesbillet	
4	vand	54	0.00010	5	49	sodavand,danskvand,gravand,observand,mineralvand	kølvand,farvand,sodavand,drikkevand,grundvand,spildevand,regnvand,springvand,saltvand,havvand,badevand,saftevand,kildevand,ferskvand,tidevand,danskvand,postevand,smeltevand,overfladevand,mundvand,isvand,kloakvand,sæbevand,brugsvand,kølevand,territorialfarvand,klorvand,kondensvand,fostervand,buksevand,brakvand,rosenvand,vievand,bundvand,drænvand,skyllevand,tevand,mineralvand,fladvand,kølnervand,kongevand,dybvand,varmtvand,idvand,tungtvand,brygvand,borvand,blegevand,fødevand
4	arve	38	0.00010	38	0	farve,hudfarve,larve,hårfarve,pastelfarve,pangfarve,klangfarve,kontrastfarve,grundfarve,modefarve,vandfarve,frugtfarve,harve,oliefarve,bundfarve,høstfarve,primærfarve,limfarve,signalfarve,komplementærfarve,trykfarve,plantefarve,dækfarve,spektralfarve,målerlarve,lokalfarve,laksefarve,sekundærfarve,krapfarve,tallerkenharve,bremselarve,amarantfarve,spartelfarve,hoffarve,rødarve,purpurfarve,bækarve,lasurfarve	
4	ejer	28	0.00010	28	0	boligejer,lejer,medejer,husejer,udlejer,gårdejer,godsejer,bilejer,dagplejer,lodsejer,grundejer,plejer,galleriejer,skorstensfejer,tandplejer,bådejer,kioskejer,daglejer,vejer,drejer,gadefejer,sygeplejer,selvejer,mejer,plebejer,lurendrejer,fodplejer,fremlejer	
4	iste	54	0.00010	54	0	liste,venteliste,kiste,hitliste,rangliste,borgerliste,rolleliste,facitliste,lokalliste,prisliste,tjekliste,ligkiste,litteraturliste,positivliste,dødsliste,indkøbsliste,partiliste,ordliste,skatkiste,huskeliste,playliste,dårekiste,mailingliste,dragkiste,rødliste,spilleliste,tabsliste,bruttoliste,sortliste,trækningsliste,negativliste,kantliste,inventarliste,pynteliste,hjernekiste,skibskiste,slamkiste,kramkiste,materialeliste,shortliste,hellekiste,civilliste,fejeliste,dækliste,friliste,ekspektanceliste,tegningsliste,stykliste,skyggeliste,stødliste,vaterliste,dødeliste,skråliste,præsensliste	
4	ktur	21	0.00010	18	3	struktur,arkitektur,infrastruktur,konjunktur,højkonjunktur,lavkonjunktur,akupunktur,korrektur,druktur,fraktur,manufaktur,punktur,dybdestruktur,autokorrektur,tinktur,jodtinktur,urstruktur,konjektur	adjunktur,præfektur,kontaktur
4	åben	20	0.00010	0	20		våben,atomvåben,flyvevåben,skydevåben,masseødelæggelsesvåben,luftvåben,håndvåben,kernevåben,automatvåben,slagvåben,byvåben,rigsvåben,mordvåben,stikvåben,håndskydevåben,stødvåben,antiraketvåben,hugvåben,a-våben,skræmmevåben
4	ntor	24	0.00009	4	20	mentor,kantor,alkvantor,kvantor	kontor,turistkontor,postkontor,bistandskontor,socialkontor,billetkontor,kommunekontor,kirkekontor,forkontor,motorkontor,dommerkontor,storrumskontor,vekselkontor,enmandskontor,toldkontor,notarialkontor,rodekontor,lånekontor,kassererkontor,ministerialkontor
4	dler	59	0.00009	58	1	forhandler,handler,sagsbehandler,boghandler,behandler,svindler,pendler,formidler,grønthandler,chefforhandler,fiskehandler,narkohandler,kunsthandler,topforhandler,vinhandler,mellemhandler,våbenhandler,cykelhandler,blomsterhandler,detailhandler,valutahandler,farvehandler,ostehandler,fotohandler,ejendomshandler,dyrehandler,antikvarboghandler,storsvindler,gadehandler,manufakturhandler,menneskehandler,spindler,forlagsboghandler,herreekviperingshandler,eneforhandler,slavehandler,frimærkehandler,vildthandler,frugthandler,tobakshandler,forædler,børnemishandler,kreaturhandler,modehandler,mishandler,cigarhandler,arbejdsformidler,produkthandler,tipsforhandler,viktualiehandler,bladhandler,fuglehandler,skibshandler,kornhandler,underhandler,kolonialhandler,padler,materialhandler	rødler
4	stri	23	0.00009	23	0	industri,medicinalindustri,filmindustri,tobaksindustri,fiskeindustri,underholdningsindustri,tekstilindustri,byggeindustri,jernindustri,storindustri,medicinindustri,sværindustri,levnedsmiddelindustri,teleindustri,kunstindustri,småindustri,kemiindustri,følgeindustri,køleindustri,nøgleindustri,popindustri,forlystelsesindustri,IT-industri	
4	apir	45	0.00009	2	43	tapir,skaberaktapir	papir,værdipapir,bagepapir,toiletpapir,avispapir,brevpapir,arbejdspapir,sandpapir,sølvpapir,identitetspapir,gavepapir,talepapir,genbrugspapir,fluepapir,silkepapir,rispapir,madpapir,slikpapir,pergamentpapir,ispapir,trækpapir,glanspapir,mellemlægspapir,karbonpapir,kopipapir,returpapir,smørrebrødspapir,bøttepapir,forståelsespapir,karduspapir,crepepapir,filtrerpapir,skrivepapir,kalkerpapir,hyldepapir,klisterpapir,klatpapir,kopierpapir,konceptpapir,WC-papir,forsatspapir,indiapapir,trykpapir
4	aske	49	0.00009	49	0	flaske,taske,maske,håndtaske,skoletaske,netmaske,gasmaske,gasflaske,sutteflaske,vinflaske,havtaske,skuldertaske,ansigtsmaske,sodavandsflaske,iltmaske,dametaske,køletaske,toilettaske,lædertaske,dødsmaske,flyveaske,halvflaske,returflaske,dykkermaske,helflaske,magnumflaske,attachétaske,termoflaske,halvmaske,støvmaske,potaske,weekendtaske,feltflaske,pusletaske,sladdertaske,rendemaske,klukflaske,hyrdetaske,saddeltaske,pølsetaske,vrangmaske,halvliterflaske,visittaske,helliterflaske,laske,halvandenliterflaske,fægtemaske,enliterflaske,retmaske	
4	kort	76	0.00009	2	74	dekort,tidkort	kørekort,dankort,kreditkort,postkort,landkort,gavekort,menukort,visitkort,verdenskort,betalingskort,klippekort,julekort,vinkort,girokort,spisekort,skattekort,søkort,buskort,rejsekort,hævekort,liftkort,kontokort,valgkort,bykort,årskort,månedskort,taletidskort,spillekort,frikort,grafikkort,identitetskort,lydkort,pressekort,sæsonkort,togkort,nøglekort,periodekort,lånerkort,partoutkort,bordkort,fiskekort,vejrkort,boardingkort,brevkort,takkekort,telekort,netkort,printkort,pensionistkort,købekort,billedkort,skærmkort,tarokkort,sankekort,stamkort,bikort,hovedkort,generalstabskort,titurskort,indbydelseskort,adressekort,vægkort,københavnskort,trækkort,fanekort,sim-kort,bornholmskort,firkort,reliefkort,fælleskort,ID-kort,bruttotrækkort,vandrerkort,konturkort
4	ilje	20	0.00009	20	0	vilje,modvilje,velvilje,uvilje,vanilje,lilje,offervilje,påskelilje,fightervilje,forhandlingsvilje,pinselilje,vrangvilje,daglilje,egenvilje,dorotealilje,gøgelilje,pragtlilje,sværdlilje,belladonnalilje,giftlilje	
4	tant	22	0.00008	22	0	repræsentant,debutant,tillidsrepræsentant,protestant,kombattant,dilettant,sikkerhedsrepræsentant,mutant,borgerrepræsentant,arrestant,konstant,adoptant,arbejdsmiljørepræsentant,sekstant,aktant,restant,nonkombattant,optant,hospitant,reflektant,resultant,attestant	
4	øber	38	0.00008	38	0	køber,løber,skiløber,udløber,forløber,indkøber,frontløber,medløber,opkøber,friløber,hurtigløber,døber,skøjteløber,overløber,grænseoverløber,kandestøber,skovløber,hækkeløber,seksløber,kondiløber,kunstskøjteløber,bronzestøber,væddeløber,tilløber,ultraløber,styrtløber,stafetløber,støber,cementstøber,bordløber,klokkestøber,træløber,sandløber,stylteløber,lysestøber,kapløber,kærløber,skriftstøber	
4	kine	62	0.00008	62	0	maskine,vaskemaskine,søgemaskine,flyvemaskine,skrivemaskine,opvaskemaskine,pengemaskine,boremaskine,kaffemaskine,gravemaskine,symaskine,spillemaskine,landbrugsmaskine,kopimaskine,regnemaskine,dampmaskine,græsslåmaskine,vridemaskine,datamaskine,køkkenmaskine,barbermaskine,skruemaskine,romaskine,røremaskine,fejemaskine,evighedsmaskine,faskine,malkemaskine,slibemaskine,høstmaskine,flippermaskine,såmaskine,rugemaskine,slagboremaskine,kødhakkemaskine,båndmaskine,trykkemaskine,slåmaskine,helvedesmaskine,strikkemaskine,skæremaskine,kølemaskine,blandemaskine,hæftemaskine,knusemaskine,fræsemaskine,brødmaskine,hullemaskine,sættemaskine,rensemaskine,tappemaskine,tærskemaskine,stansemaskine,skopudsemaskine,hakkelsemaskine,bænkboremaskine,grave-læsse-maskine,mejemaskine,clipsemaskine,grødeskæremaskine,elektrisermaskine,æltemaskine	
4	ffer	23	0.00008	9	14	træffer,fuldtræffer,buffer,blaffer,skaffer,sniffer,ruffer,bluffer,kaffer	offer,ciffer,dødsoffer,voldsoffer,mobbeoffer,trafikoffer,torturoffer,sonoffer,brændoffer,slagtoffer,chiffer,takoffer,drikoffer,skyldoffer
4	edel	44	0.00008	44	0	tredjedel,fjerdedel,femtedel,reservedel,størstedel,tiendedel,kedel,pedel,sjettedel,hundrededel,heksekedel,elkedel,ottendedel,tusindedel,milliontedel,syvendedel,gruekedel,tyvendedel,milliardtedel,tolvtedel,niendedel,kobberkedel,fløjtekedel,sekstendedel,billiontedel,attendedel,treogtyvendedel,nittendedel,bryggekedel,niogtyvendedel,toogtyvendedel,trettendedel,tredivtedel,seksogtyvendedel,fireogtyvendedel,enogtyvendedel,femtendedel,otteogtyvendedel,ellevtedel,syvogtyvendedel,donkeykedel,femogtyvendedel,fjortendedel,syttendedel	
4	lage	20	0.00008	20	0	anklage,klage,emballage,plage,collage,flage,karambolage,isflage,landeplage,camouflage,sukkerlage,saltlage,ensilage,jammerklage,persiflage,påklage,hirseflage,takkelage,fuselage,veklage	
4	leje	50	0.00008	32	18	husleje,pleje,dagpleje,ældrepleje,hjemmepleje,sygepleje,tandpleje,familiepleje,retspleje,hjemmesygepleje,hudpleje,menighedspleje,kundepleje,døgnpleje,udleje,yngelpleje,imagepleje,fremleje,akeleje,skoletandpleje,formuepleje,vildtpleje,fodpleje,kurspleje,kropspleje,hårpleje,barnepleje,kabbeleje,langtidsleje,engkabbeleje,boksleje,dagleje	samleje,dødsleje,færgeleje,toneleje,fiskerleje,prisleje,sygeleje,kugleleje,sengeleje,flodleje,stemmeleje,stemningsleje,stilleje,mellemleje,sideleje,smertensleje,nationaleje,kulleje
4	æsen	25	0.00008	0	25		væsen,sundhedsvæsen,brandvæsen,skattevæsen,postvæsen,retsvæsen,skolevæsen,toldvæsen,rumvæsen,bankvæsen,uvæsen,telegrafvæsen,vejvæsen,pengevæsen,telefonvæsen,fornuftsvæsen,skovvæsen,parkvæsen,fyrvæsen,kastevæsen,landvæsen,klikevæsen,pensionsvæsen,klitvæsen,åndevæsen
4	gård	33	0.00008	33	0	kirkegård,banegård,hovedbanegård,præstegård,herregård,sognegård,baggård,skolegård,vingård,bondegård,hovedgård,købmandsgård,skærgård,slægtsgård,fattiggård,hønsegård,ødegård,avlsgård,forgård,ladegård,kravlegård,kongsgård,bispegård,godsbanegård,klostergård,gæstgivergård,lystgård,urtegård,bilkirkegård,ormegård,borggård,fæstegård,fædrenegård	
4	etal	22	0.00008	3	19	dødsmetal,death metal,heavy metal	mindretal,metal,nøgletal,timetal,stemmetal,tungmetal,ædelmetal,mørketal,sidetal,ottetal,letmetal,endetal,tretal,attenhundredetal,hårdmetal,nittenhundredetal,ellevetal,hvidmetal,mængdetal
4	otor	21	0.00008	21	0	motor,dieselmotor,benzinmotor,promotor,påhængsmotor,forbrændingsmotor,boksepromotor,jetmotor,bådmotor,rotor,elektromotor,hjælpemotor,hækmotor,rugbrødsmotor,totaktsmotor,boksermotor,stempelmotor,udenbordsmotor,firetaktsmotor,eksplosionsmotor,primus motor	
4	kken	21	0.00008	2	19	omflakken,genopdukken	køkken,bækken,storkøkken,folkekøkken,skolekøkken,centralkøkken,udekøkken,gadekøkken,tekøkken,spisekøkken,grovkøkken,feltkøkken,dækken,elementkøkken,hestedækken,flykøkken,nyrebækken,stormkøkken,flyvekøkken
4	vare	39	0.00008	39	0	fødevare,råvare,drikkevare,madvare,mærkevare,dagligvare,mangelvare,handelsvare,kopivare,metervare,hvidevare,mellemvare,tobaksvare,slagvare,færdigvare,kolonialvare,grovvare,ferskvare,røgvare,lagervare,strikvare,tekstilvare,konsumvare,sekundavare,trævare,malervare,dybfrostvare,lervare,galanterivare,stabelvare,billigvare,serievare,medicinalvare,transitvare,klædevare,konditorvare,materialvare,godtkøbsvare,korpusvare	
4	kker	106	0.00008	90	16	makker,oprykker,dykker,afstikker,firehjulstrækker,trækker,rykker,aftrækker,skruetrækker,nedrykker,stikker,nøddeknækker,undertrykker,appetitvækker,trykker,røgdykker,lukker,klokker,proptrækker,knivstikker,børnelokker,okker,bogtrykker,plukker,pulverslukker,fluesmækker,brandslukker,murbrækker,slukker,lyseslukker,dobbeltdækker,lappedykker,stivstikker,kødhakker,betablokker,forhjulstrækker,skruebrækker,skumslukker,tagdækker,kaffedrikker,ildslukker,sportsdykker,eftersnakker,løntrykker,oplukker,rakker,øloplukker,spytslikker,lokker,opkvikker,tedrikker,strikker,trekker,skallesmækker,kobberstikker,stoftrykker,svømmedykker,kukker,kulsukker,morakker,stjerneskruetrækker,gibbernakker,holbækker,stenpikker,sidemakker,tagtækker,udstykker,persillehakker,todækker,optrækker,selvplukker,kulsyreslukker,dørlukker,offsettrykker,kedelflikker,spaltelukker,rokker,pakker,tredækker,solblokker,udrykker,vandskrækker,poselukker,tækker,indpakker,shelterdækker,vækker,silketrykker,esmakker,lybækker	sukker,blodsukker,rørsukker,druesukker,puddersukker,mælkesukker,florsukker,frugtsukker,perlesukker,strøsukker,råsukker,roesukker,invertsukker,demerarasukker,krystalsukker,kandissukker
4	stid	30	0.00008	30	0	arbejdstid,åbningstid,årstid,efterkrigstid,livstid,istid,oplysningstid,betænkningstid,mellemkrigstid,midnatstid,fredstid,kvalitetstid,besøgstid,nytårstid,ekspeditionstid,aftenstid,mellemistid,flekstid,inkubationstid,førkrigstid,karenstid,forårstid,parringstid,butikstid,latenstid,efterårstid,rotationstid,fikstid,hævdstid,triastid	
4	ykel	27	0.00007	27	0	cykel,motorcykel,bycykel,racercykel,kondicykel,motionscykel,damecykel,elcykel,ladcykel,herrecykel,skinnecykel,vandcykel,budcykel,tandemcykel,foldecykel,løbecykel,halvcykel,barnecykel,minicykel,turcykel,turistcykel,tricykel,ergometercykel,hybridcykel,hemicykel,klubcykel,BMX-cykel	
4	ille	65	0.00007	62	3	brille,pille,persille,promille,krokodille,bille,lykkepille,rille,trille,dille,vitaminpille,stikpille,sovepille,ratatouille,eskadrille,bropille,kamille,bacille,vaudeville,fortrydelsespille,grille,nervepille,modedille,hornbrille,flotille,støttepille,solbrille,frille,borebille,kvadrille,kruspersille,læsebrille,snudebille,løbebille,barkbille,nilkrokodille,coloradobille,chenille,bærepille,stræbepille,næsehornsbille,reveille,grundskyldpromille,minipille,titaniumbrille,gødningsbille,espadrille,bombarderbille,kochenille,ådselbille,grønpille,kardinalbille,svømmebrille,præventivpille,nonpareille,cedille,praltrille,p-pille,hørebrille,brødbille,køllebille,kokille	skille,vindstille,stille
4	vogn	68	0.00007	68	0	campingvogn,kampvogn,barnevogn,sportsvogn,varevogn,lastvogn,sporvogn,undervogn,pølsevogn,skurvogn,hestevogn,togvogn,folkevogn,kassevogn,mandskabsvogn,klapvogn,hyrevogn,tankvogn,fotovogn,rustvogn,sidevogn,blokvogn,sættevogn,trækvogn,godsvogn,personvogn,påhængsvogn,servicevogn,sovevogn,panservogn,skraldevogn,sækkevogn,jernbanevogn,kreaturvogn,vandvogn,kranvogn,spisevogn,stigevogn,teltvogn,prærievogn,flyttevogn,kølevogn,dukkevogn,sendevogn,hollændervogn,bivogn,pejlevogn,skolevogn,liggevogn,tipvogn,ledsagevogn,kapervogn,brugtvogn,fladvogn,skovvogn,gøglervogn,optagevogn,venusvogn,fragtvogn,trillevogn,pakvogn,trolleyvogn,enspændervogn,bogievogn,topersonersvogn,ponyvogn,enejersvogn,firepersonersvogn	
4	røve	37	0.00007	37	0	prøve,blodprøve,smagsprøve,generalprøve,afgangsprøve,stikprøve,styrkeprøve,køreprøve,svendeprøve,lakmusprøve,læseprøve,lydprøve,vareprøve,terminsprøve,stopprøve,årsprøve,jagtprøve,ildprøve,spiritusprøve,farveprøve,adgangsprøve,kraftprøve,forprøve,synsprøve,intelligensprøve,høreprøve,duelighedsprøve,materialeprøve,omprøve,penneprøve,svømmeprøve,skolemodenhedsprøve,kontraprøve,indstillingsprøve,rorschachprøve,lappeprøve,frisvømmerprøve	
4	blad	52	0.00007	9	43	gedeblad,bukkeblad,tornblad,søblad,hornblad,pilblad,skeblad,firblad,sylblad	dagblad,ugeblad,fagblad,laurbærblad,dameblad,barberblad,kronblad,figenblad,sladderblad,kirkeblad,skulderblad,flyveblad,generalieblad,titelblad,palmeblad,rosenblad,skoleblad,distriktsblad,faneblad,teblad,bøgeblad,knivblad,fejeblad,løsblad,bægerblad,dækblad,kimblad,kløverblad,savblad,hjerteblad,dæksblad,støvblad,spydblad,smudsblad,romanblad,bovblad,omblad,skovlblad,økseblad,rørblad,skeblad,skilleblad,skrueblad
4	ange	28	0.00007	28	0	fange,lange,slange,krigsfange,tange,orange,straffefange,vange,kvælerslange,giftslange,søslange,klapperslange,brandslange,samvittighedsfange,havslange,flugtfange,landtange,pytonslange,melange,kobraslange,flange,brilleslange,coxorange,spuleslange,gasslange,æskulapslange,kz-fange,rørflange	
4	reds	24	0.00007	24	0	kreds,omgangskreds,inderkreds,vennekreds,valgkreds,storkreds,kundekreds,rundkreds,studiekreds,omkreds,retskreds,læsekreds,enkeltmandskreds,læserkreds,dyrekreds,bibelkreds,vendekreds,skyldkreds,sagnkreds,strømkreds,synskreds,polarkreds,breddekreds,længdekreds	
4	deri	45	0.00007	0	45		rederi,krydderi,skænderi,skyderi,forræderi,broderi,raffinaderi,bogholderi,myrderi,snyderi,formynderi,roderi,olieraffinaderi,skilderi,højforræderi,skoleskyderi,bryderi,spinderi,bogbinderi,overformynderi,hjemmebrænderi,marketenderi,natteroderi,brænderi,kalkbrænderi,tuderi,sukkerraffinaderi,gnideri,trolderi,dødbideri,ordgyderi,provencekrydderi,afguderi,solderi,partrederi,flerguderi,trusserederi,vodbinderi,hærderi,teglbrænderi,skrædderi,binderi,anderi,æreskænderi,gobelinbroderi
4	veri	27	0.00007	0	27		røveri,tyveri,skriveri,slaveri,bankrøveri,hjemmerøveri,tricktyveri,brugstyveri,identitetstyveri,rambuktyveri,garveri,liebhaveri,væveri,gæstgiveri,angiveri,sørøveri,ordkløveri,kvaksalveri,hoveri,farveri,skrankepaveri,bengnaveri,gnaveri,driveri,rethaveri,gobelinvæveri,hårkløveri
4	dsel	24	0.00007	17	7	fødsel,rædsel,færdsel,genfødsel,skændsel,skærmydsel,tidsel,barnefødsel,jomfrufødsel,hjemmefødsel,samfærdsel,dødfødsel,sædefødsel,efterfødsel,agertidsel,marietidsel,brøndsel	gidsel,brændsel,biobrændsel,ådsel,bidsel,vindsel,bindsel
4	ande	32	0.00007	28	4	pande,bande,kande,bradepande,termokande,risalamande,stegepande,guirlande,reprimande,åkande,tyvebande,vandkande,grande,tekande,røverbande,stempelkande,skaldepande,granguirlande,kontrabande,kvajpande,sarabande,sauterepande,saucekande,smørekande,tande,indsande,allemande,pytipande	dødvande,højvande,lavvande,indsande
4	mmel	27	0.00007	23	4	himmel,strimmel,hjemmel,skammel,stjernehimmel,vrimmel,nattehimmel,lovhjemmel,lømmel,skimmel,sejrsskammel,tommel,tummel,hammel,fodskammel,rejsehjemmel,rummel,blåskimmel,gråskimmel,stimmel,tronhimmel,klæbestrimmel,kassestrimmel	skrammel,skrummel,krymmel,programmel
4	stue	43	0.00007	43	0	skadestue,vuggestue,tegnestue,dagligstue,spisestue,legestue,varmestue,udestue,julestue,konfirmandstue,opholdsstue,badstue,systue,havestue,slyngelstue,enestue,vinstue,jættestue,krostue,frokoststue,kaffestue,pejsestue,mindestue,fødestue,hospitalsstue,sygestue,forstue,fællesstue,vinkelstue,vævestue,storstue,skrivestue,skænkestue,samlingsstue,folkestue,flersengsstue,gildestue,stadsestue,betjentstue,tosengsstue,belægningsstue,sektionsstue,borgestue	
4	brik	20	0.00006	20	0	fabrik,rubrik,maskinfabrik,klædefabrik,cementfabrik,tobaksfabrik,dominobrik,underrubrik,konservesfabrik,skakbrik,filetfabrik,kemifabrik,refleksbrik,ølbrik,trikotagefabrik,mellemrubrik,juicebrik,nøglebrik,trævarefabrik,smørebrik	
4	eret	36	0.00006	36	0	højesteret,stemmeret,skifteret,folkeret,eneret,landsskatteret,menneskeret,strafferet,råderet,møderet,fiskeret,dagpengeret,beret,gryderet,klageret,skoleret,skatteret,arveret,førsteret,deputeret,håneret,delegeret,familieret,kommitteret,taleret,ligeret,byggeret,formueret,køberet,bytteret,herreret,sædvaneret,skueret,påtaleret,panteret,chefdelegeret	
4	ølle	26	0.00006	26	0	mølle,vindmølle,kølle,bølle,krølle,golfkølle,havmølle,lammekølle,trædemølle,svikmølle,fodboldbølle,vejrmølle,fartbølle,oliemølle,slangekrølle,pølle,dyrekølle,stubmølle,bedemølle,motorbølle,mosebølle,rådyrkølle,spytkrølle,krudtmølle,dådyrkølle,stampemølle	
4	sret	34	0.00006	34	0	landsret,ejendomsret,ophavsret,indfødsret,forvaltningsret,fortrydelsesret,rigsret,voldgiftsret,fortrinsret,forkøbsret,brugsret,selvbestemmelsesret,egnsret,tegningsret,selskabsret,forfatningsret,fortegningsret,statsret,krigsret,forhandlingsret,førstefødselsret,samkvemsret,samværsret,forkørselsret,procesret,dispositionsret,obligationsret,købsret,allemandsret,trækningsret,højhedsret,tingsret,tilbageholdsret,næringsret	
4	nser	59	0.00006	58	1	palæstinenser,danser,balletdanser,solodanser,vejlenser,panser,esbjergenser,svendborgenser,koldingenser,nyborgenser,linedanser,silkeborgenser,viborgenser,klunser,roskildenser,mavedanser,ripenser,herningenser,dispenser,aalborgenser,piberenser,bogenser,faaborgenser,køgenser,renser,sportsdanser,stepdanser,hjørringenser,tarmrenser,cistercienser,skanderborgenser,vardenser,flaskerenser,kretenser,radrenser,bergenser,athenienser,nykøbingenser,kalundborgenser,flænser,genser,vordingborgenser,sønderborgenser,neglerenser,grenaaenser,sprogrenser,fordanser,sakskøbingenser,sporrenser,rudkøbingenser,grenaagenser,damprenser,mariagergenser,lundenser,stubbekøbingenser,stegenser,ringkøbingenser,hedtvandsrenser	panser
4	aver	48	0.00006	44	4	indehaver,magthaver,andelshaver,velhaver,medindehaver,graver,traver,gnaver,rettighedshaver,anpartshaver,rendegraver,liebhaver,guldgraver,panthaver,palaver,kontohaver,naver,parthaver,rekordindehaver,shaver,eneindehaver,slaver,brøndgraver,staver,licenshaver,kortindehaver,raver,bevillingshaver,patenthaver,ihændehaver,fordringshaver,undergraver,koncessionshaver,grøftegraver,ladyshaver,bengnaver,skattegraver,kædegraver,screensaver,prioritetshaver,ådselgraver,udpantningshaver,rethaver,håndpanthaver	klaver,kadaver,naver,hammerklaver
4	fuld	32	0.00006	30	2	håndfuld,spiseskefuld,teskefuld,mundfuld,skefuld,røvfuld,busfuld,endefuld,himmerigsmundfuld,tankfuld,skovlfuld,spandfuld,nævefuld,hatfuld,skålfuld,favnfuld,posefuld,tallerkenfuld,grydefuld,vognfuld,kopfuld,kurvfuld,sækfuld,skudefuld,redefuld,barneskefuld,topskefuld,æskefuld,spadefuld,bøttefuld	læsfuld,fadfuld
4	elle	29	0.00006	28	1	celle,novelle,frikadelle,solcelle,helle,stamcelle,sædcelle,delle,brændselscelle,fiskefrikadelle,terrorcelle,gazelle,svelle,ægcelle,isolationscelle,fedtcelle,enecelle,fotocelle,tagliatelle,dødscelle,munkecelle,strafcelle,brændstofcelle,klostercelle,brunelle,libelle,fontanelle,pimpinelle	helle
4	tage	23	0.00006	23	0	etage,reportage,plantage,stage,stueetage,sabotage,lysestage,montage,underetage,slitage,klitplantage,tagetage,kurtage,overetage,fotomontage,eremitage,fustage,bønnestage,trikotage,affutage,kolportage,dekolletage,sprydstage	
4	ifte	28	0.00006	1	27	vifte	årsskifte,skifte,generationsskifte,systemskifte,kursskifte,stofskifte,årtusindeskifte,sporskifte,ejerskifte,jobskifte,vagtskifte,hamskifte,replikskifte,tronskifte,kønsskifte,århundredeskifte,formandsskifte,månedsskifte,sædskifte,mageskifte,fodskifte,skrifte,ordskifte,trosskifte,løberskifte,indgifte,kopskifte
4	kant	44	0.00006	44	0	udkant,trafikant,fabrikant,trekant,forkant,praktikant,prædikant,firkant,underkant,overkant,vejkant,vandkant,venstrekant,strandkant,højrekant,musikant,grøftekant,yderkant,bagkant,diskant,vækkelsesprædikant,hadprædikant,advarselstrekant,erhvervspraktikant,fedtkant,lægprædikant,femkant,ribkant,sekskant,gårdmusikant,blondekant,ottekant,krokant,håndkant,kommunikant,sekant,ægkant,tungekant,vindikant,vankant,mangekant,hældekant,skråkant,forpraktikant	
4	trøm	20	0.00006	20	0	strøm,pengestrøm,slipstrøm,understrøm,talestrøm,malstrøm,luftstrøm,ordstrøm,vekselstrøm,modstrøm,jævnstrøm,jetstrøm,stærkstrøm,svagstrøm,kørestrøm,fejlstrøm,nødstrøm,ångstrøm,induktionsstrøm,krybestrøm	
4	klub	23	0.00006	23	0	boldklub,fodboldklub,natklub,håndboldklub,sejlklub,ungdomsklub,divisionsklub,roklub,fanklub,sportsklub,fritidsklub,bogklub,ældreklub,kaffeklub,kajakklub,filmklub,rockerklub,kortklub,spilleklub,karateklub,kennelklub,syklub,fællesklub	
4	nlæg	26	0.00006	0	26		anlæg,sagsanlæg,rensningsanlæg,klimaanlæg,stereoanlæg,renseanlæg,arveanlæg,forbrændingsanlæg,betalingsanlæg,køleanlæg,navigationsanlæg,kajanlæg,fællesantenneanlæg,samtaleanlæg,centralvarmeanlæg,nødkaldeanlæg,kaldeanlæg,surroundanlæg,karaokeanlæg,genbrugsanlæg,offshoreanlæg,hi-fi-anlæg,blødtvandsanlæg,fugtighedsanlæg,havanlæg,personsøgeanlæg
4	gter	42	0.00006	42	0	digter,slagter,sværvægter,vogter,målvogter,forpagter,betragter,fangevogter,vægter,eventyrdigter,militærnægter,letvægter,nægter,tyrefægter,benægter,fægter,linjevogter,dørvogter,weltervægter,mellemvægter,supersværvægter,affugter,flugter,kostforagter,fluevægter,bantamvægter,befragter,ledvogter,foragter,fornægter,halalslagter,guldalderdigter,gudsfornægter,røgter,cruiservægter,natvægter,lægter,visedigter,helflugter,halvflugter,befugter,odedigter	
4	yder	35	0.00006	35	0	skatteyder,forbryder,udbyder,krigsforbryder,udbryder,bryder,livsnyder,snyder,mønsterbryder,internetudbyder,isbryder,flyder,indskyder,skyder,sexforbryder,nyder,lovbryder,afbryder,skattesnyder,vaneforbryder,voldsforbryder,bølgebryder,seksualforbryder,bidragsyder,indbyder,banebryder,sumobryder,fribryder,drømmetyder,stjernetyder,strejkebryder,ordgyder,knivafbryder,vindbryder,skryder	
4	bund	23	0.00006	17	6	grobund,havbund,skovbund,klangbund,jordbund,kistebund,hovedbund,bækkenbund,lagkagebund,hårbund,resonansbund,artiskokbund,mosebund,lamelbund,surbund,sangbund,spiralbund	forbund,valgforbund,specialforbund,oplysningsforbund,statsforbund,listeforbund
4	ante	39	0.00006	37	2	plante,tante,potteplante,stueplante,vante,lægeplante,guvernante,prydplante,slyngplante,ukrudtsplante,jante,løgplante,kulturplante,bælgplante,klatreplante,nytteplante,skærmplante,grandtante,frøplante,servante,spumante,værtsplante,drivhusplante,kokaplante,bælgvante,legetante,fingervante,karsporeplante,snylteplante,sporeplante,halvtante,maniokplante,fjante,rådplante,spindplante,andante,sirplante	spumante,andante
4	barn	58	0.00006	0	58		barnebarn,småbarn,spædbarn,bysbarn,enebarn,hjertebarn,oldebarn,vidunderbarn,problembarn,pigebarn,legebarn,smertensbarn,adoptivbarn,skilsmissebarn,ønskebarn,fødselsdagsbarn,plejebarn,menneskebarn,skolebarn,stedbarn,hittebarn,særbarn,feriebarn,tipoldebarn,bonusbarn,reagensglasbarn,pattebarn,gudbarn,gadebarn,bybarn,dukkebarn,fællesbarn,papbarn,delebarn,mongolbarn,sognebarn,søndagsbarn,troldebarn,brystbarn,kælebarn,flaskebarn,gudebarn,førskolebarn,regnbuebarn,ørebarn,nøglebarn,niårsbarn,DAMP-barn,svøbelsebarn,diebarn,gammelmandsbarn,damp-barn,søskendebarn,elleveårsbarn,toårsbarn,ægtebarn,næstsøskendebarn,skødebarn
4	stof	38	0.00006	0	38		brændstof,sprængstof,kvælstof,råstof,næringsstof,tilsætningsstof,fedtstof,grundstof,giftstof,antistof,farvestof,kulstof,læsestof,foderstof,kunststof,affaldsstof,smagsstof,forsidestof,aromastof,sødestof,sporstof,tørstof,kontraststof,fyldstof,smitstof,bitterstof,æggehvidestof,urinstof,petitstof,garvestof,forbindsstof,lærestof,lærredsstof,jerseystof,røbestof,cellstof,formstof,ostestof
4	rske	28	0.00006	28	0	sygeplejerske,sundhedsplejerske,syerske,hjemmesygeplejerske,oversygeplejerske,afdelingssygeplejerske,husholderske,samleverske,operationssygeplejerske,murske,sandsigerske,væverske,ledsagerske,plejerske,morderske,rytterske,påklæderske,skolesundhedsplejerske,kassererske,eventyrerske,indehaverske,sigøjnerske,tiggerske,rufferske,kogerske,naboerske,kætterske,vogterske	
4	thed	37	0.00006	37	0	bevidsthed,lethed,berømthed,enkelthed,dobbelthed,ægthed,underbevidsthed,korthed,intethed,retsbevidsthed,utæthed,plathed,befolkningstæthed,metaltræthed,uforskammethed,udsathed,forladthed,indforståethed,bestemthed,flothed,belæsthed,bundethed,direkthed,jordbundethed,blaserthed,uimponerethed,smarthed,indesluttethed,imponerethed,bekendthed,uægthed,ubundethed,forårstræthed,farveægthed,gudsbevidsthed,komplicerethed,betagethed	
4	park	24	0.00006	12	12	nationalpark,forlystelsespark,vindmøllepark,strandpark,bypark,bilpark,naturpark,dyrepark,vognpark,temapark,klatrepark,naturnationalpark	spark,straffespark,frispark,hjørnespark,udspark,saksespark,målspark,cirkelspark,vristspark,æselspark,hælspark,indspark
4	øgle	27	0.00006	25	2	nøgle,fordelingsnøgle,svensknøgle,kæmpeøgle,skruenøgle,flyveøgle,startnøgle,skiftenøgle,topnøgle,universalnøgle,fastnøgle,skraldenøgle,unbrakonøgle,G-nøgle,krydsnøgle,telefonnøgle,basnøgle,sekskantnøgle,altnøgle,USB-nøgle,bratschnøgle,rettenøgle,diskantnøgle,C-nøgle,F-nøgle	nøgle,garnnøgle
4	omme	27	0.00006	25	2	tromme,tomme,lomme,blomme,æggeblomme,baglomme,kardemomme,tidslomme,inderlomme,bukselomme,stortromme,brystlomme,bongotromme,lilletromme,buslomme,sveskeblomme,engblomme,guldblomme,forlomme,muskatblomme,flomme,stiklomme,skrålomme,katrineblomme,kjolelomme	komme,udkomme
4	etøj	36	0.00006	0	36		køretøj,legetøj,vasketøj,styretøj,sengetøj,børnetøj,syltetøj,modetøj,badetøj,motorkøretøj,dametøj,herretøj,strikketøj,udrykningskøretøj,seletøj,snakketøj,mærketøj,bæltekøretøj,skiftetøj,camouflagetøj,snavsetøj,dukketøj,mandetøj,ventetøj,låsetøj,skrivetøj,tyttebærsyltetøj,strygetøj,kyssetøj,udetøj,lukketøj,olietøj,dækketøj,hækletøj,væggetøj,alliancesyltetøj
4	isse	31	0.00006	31	0	skilsmisse,kulisse,nisse,bisse,fisse,almisse,julenisse,trisse,havenisse,kyndelmisse,citronmelisse,kravlenisse,abbedisse,drillenisse,brobisse,vatnisse,sætternisse,bouillabaisse,visse,diakonisse,potemkinkulisse,hønisse,remisse,garntrisse,melisse,recepisse,abscisse,vidisse,disse,mantisse,baisse	
4	ader	32	0.00006	32	0	fader,forfader,landsfader,turbolader,vinterbader,lader,offroader,stamfader,oplader,kirkefader,forlader,fremmedhader,brigader,kvindehader,barnefader,arvelader,solbader,skriftefader,nøgenbader,kvader,tchader,grenader,menneskehader,baglader,vandudlader,fribader,trinidader,vader,fosterfader,udlader,husfader,cheerleader	
4	test	26	0.00005	26	0	protest,straffeattest,dåbsattest,attest,crashtest,dødsattest,fødselsattest,gentest,vielsesattest,lægeattest,blindtest,helbredsattest,priktest,synstest,stortest,allergitest,navneattest,energiattest,leveattest,toldattest,psykotest,doubletest,høretest,smeartest,lappetest,tripeltest	
4	eber	21	0.00005	18	3	peber,feber,høfeber,chilipeber,rejsefeber,nældefeber,denguefeber,lampefeber,skarlagensfeber,sårfeber,gigtfeber,koldfeber,kirtelfeber,klimatfeber,betelpeber,tredagesfeber,kalvekastningsfeber,svingefeber	peber,cayennepeber,chilipeber
4	ombe	25	0.00005	25	0	bombe,atombombe,selvmordsbombe,bilbombe,vejsidebombe,klyngebombe,brandbombe,brevbombe,katakombe,krysantemumbombe,brintbombe,sexbombe,rørbombe,plombe,bordbombe,røgbombe,stinkbombe,dybvandsbombe,neutronbombe,rombe,telefonbombe,guldplombe,hekatombe,a-bombe,b-bombe	
4	dder	59	0.00005	42	17	ridder,sludder,sladder,redder,skrædder,vædder,fadder,livredder,bisidder,odder,tempelridder,lykkeridder,stodder,korsridder,besidder,oversidder,krydder,landevejsridder,dameskrædder,morgenkrydder,gralsridder,afrydder,kvidder,edder,ludder,teaterskrædder,pælesidder,elefantridder,lappeskrædder,indsidder,overkrydder,faddersladder,sliddersladder,eftersidder,dodder,benedder,godsbesidder,skvadder,narkoludder,underkrydder,minerydder,oprydder	sludder,mudder,kludder,smadder,fnidder,pladder,pudder,personfnidder,fnadder,kvidder,pludder,plidderpladder,skvadder,sliddersladder,pjadder,gnidder,talkumpudder
4	teri	67	0.00005	2	65	dysenteri,difteri	slagteri,batteri,lotteri,hysteri,iværksætteri,gætteri,stutteri,pirateri,mytteri,kammerateri,rytteri,klasselotteri,infanteri,glaspusteri,artisteri,kætteri,fjerkræslagteri,spilfægteri,krybskytteri,småtteri,andelsslagteri,massehysteri,fantasteri,mosteri,juristeri,charcuteri,kæresteri,blandingsbatteri,koketteri,dyneløfteri,dilettanteri,pikanteri,fedteri,kafferisteri,pedanteri,osteri,malteri,sætteri,regelrytteri,billedlotteri,marineinfanteri,galanteri,kværulanteri,bijouteri,bigotteri,paragrafrytteri,risteri,startbatteri,tallotteri,privateri,fribytteri,sofisteri,checkrytteri,klatteri,gæsteri,salteri,filisteri,litiumionbatteri,solbatteri,fusentasteri,smelteri,nikkel-cadmium-batteri,skidteri,vekselrytteri,rabulisteri
4	sten	78	0.00005	75	3	mursten,skorsten,brosten,gravsten,grundsten,hjørnesten,hovedrysten,kantsten,tagsten,mindesten,byggesten,ædelsten,rendesten,runesten,teglsten,sandsten,kampesten,kalksten,trappesten,rullesten,prøvesten,anstødssten,trædesten,hovedhjørnesten,møllesten,nyresten,øjesten,galdesten,flintesten,hinkesten,munkesten,smykkesten,fedtsten,slutsten,slibesten,kirsebærsten,bautasten,tandsten,vinsten,månesten,drypsten,pimpsten,chaussésten,rhinsten,rokkesten,limsten,kvadersten,brunsten,facadesten,kværnsten,hvæssesten,tungsten,frådsten,magnetjernsten,blåsten,kedelsten,pizzasten,gulsten,smutsten,skelsten,klæbersten,trykseksten,formsten,påskeøsten,piksten,brunjernsten,kragsten,lasursten,afvisersten,vegsten,ranglesten,faconsten,pusten,helvedessten,spæksten	vesten,østen,trykseksten
4	ligt	23	0.00005	22	1	pligt,værnepligt,tavshedspligt,vigepligt,skattepligt,bopælspligt,undervisningspligt,borgerpligt,mødepligt,tilbudspligt,skolepligt,visumpligt,vidnepligt,anmeldelsespligt,tjenestepligt,fredspligt,bidragspligt,højrevigepligt,hilsepligt,anmeldepligt,værtspligt,underholdspligt	endeligt
4	aler	32	0.00005	32	0	maler,fortaler,taler,kunstmaler,betaler,dealer,neandertaler,rigsdaler,healer,højtaler,daler,kavaler,portrætmaler,bugtaler,skiltemaler,emmentaler,marinemaler,orientaler,udhaler,overhaler,bengaler,provencaler,klatmaler,genremaler,miniaturemaler,sprøjtemaler,freskomaler,skåltaler,praler,italer,satellithøjtaler,fidusmaler	
4	atik	26	0.00005	26	0	matematik,problematik,dramatik,automatik,grammatik,tematik,systematik,akrobatik,informatik,dogmatik,pragmatik,batik,statik,pneumatik,numismatik,psykosomatik,telematik,somatik,datamatik,kromatik,fuldautomatik,diplomatik,emblematik,hydrostatik,elektrostatik,transformationsgrammatik	
4	ving	25	0.00005	12	13	arving,hvælving,tronarving,livsarving,himmelhvælving,tvangsarving,salving,universalarving,stagediving,tøndehvælving,kuppelhvælving,krydshvælving	sving,opsving,udsving,selvsving,højresving,venstresving,hårnålesving,håndsving,omsving,armsving,herresving,vejsving,nedsving
4	knik	26	0.00005	26	0	teknik,sparketeknik,byggeteknik,genteknik,bioteknik,spørgeteknik,køleteknik,pyroteknik,geoteknik,elektroteknik,laboratorieteknik,trykketeknik,teleteknik,medikoteknik,optageteknik,bygningsteknik,taleteknik,tandteknik,mnemoteknik,psykoteknik,polyteknik,tracerteknik,kryoteknik,hydroteknik,kemoteknik,galvanoteknik	
4	nkel	25	0.00005	25	0	vinkel,onkel,synsvinkel,ankel,indfaldsvinkel,kameravinkel,grandonkel,ranunkel,vidvinkel,legeonkel,angrebsvinkel,schenkel,skinkel,udfaldsvinkel,vandranunkel,arveonkel,halvonkel,komplementvinkel,eksplementvinkel,ægvinkel,karfunkel,topvinkel,nabovinkel,smigvinkel,centervinkel	
4	iber	27	0.00005	25	2	angriber,kaliber,fiber,glasfiber,vinkelsliber,kulfiber,griber,muskelfiber,afskiber,sliber,skærsliber,mikrofiber,piber,polyesterfiber,engpiber,skovpiber,glassliber,kostfiber,kokosfiber,diamantsliber,excentersliber,plantefiber,deltasliber,kemofiber,trekantsliber	kaliber,vulkanfiber
4	bord	39	0.00005	0	39		skrivebord,forhandlingsbord,spisebord,køkkenbord,kaffebord,middagsbord,sofabord,morgenbord,operationsbord,langbord,arbejdsbord,natbord,tegnebord,stambord,spillebord,puslebord,højbord,sengebord,rullebord,klapbord,klippebord,konferencebord,fribord,tebord,bakkebord,toiletbord,salatbord,sminkebord,anretterbord,konsolbord,aftensbord,lysbord,stigbord,trendbord,målebord,vaterbord,hæve-sænke-bord,tag selv-bord,varmebord
4	film	35	0.00005	35	0	dokumentarfilm,spillefilm,tegnefilm,kortfilm,actionfilm,pornofilm,videofilm,stumfilm,novellefilm,gyserfilm,gangsterfilm,kultfilm,kærlighedsfilm,dukkefilm,farvefilm,smalfilm,skrækfilm,splatterfilm,voldsfilm,horrorfilm,westernfilm,forfilm,talefilm,mikrofilm,helaftensfilm,mainstreamfilm,tonefilm,voksenfilm,råfilm,karatefilm,trickfilm,tre-d-film,C-film,kassettefilm,B-film	
4	pris	48	0.00005	48	0	huspris,litteraturpris,salgspris,overpris,hæderspris,forbrugerpris,benzinpris,merpris,udsalgspris,købspris,normalpris,lavpris,kilopris,mindstepris,listepris,spotpris,indkøbspris,kostpris,specialpris,jordpris,nypris,tilbudspris,stykpris,kontantpris,vurderingspris,dagspris,kuvertpris,literpris,brugtpris,maksimalpris,favørpris,fremstillingspris,førpris,detailpris,underpris,bundpris,ærenpris,nyvognspris,vennepris,cirkapris,fastpris,nupris,højsæsonpris,Nobelpris,højestepris,snitpris,tærskelpris,leveringspris	
4	ffel	31	0.00005	29	2	kartoffel,gaffel,riffel,trøffel,vaffel,karaffel,bøffel,tøffel,isvaffel,røffel,salonriffel,aspargeskartoffel,bagekartoffel,vandbøffel,griffel,læggekartoffel,forgaffel,stemmegaffel,pillekartoffel,stegegaffel,brasekartoffel,hasselbackkartoffel,giffel,åregaffel,fiskegaffel,pålægsgaffel,pølsegiffel,bintjekartoffel,bådkartoffel	taffel,nytårstaffel
4	treg	24	0.00004	24	0	streg,målstreg,genistreg,drengestreg,lærestreg,svinestreg,narrestreg,kridtstreg,bindestreg,tankestreg,tappenstreg,skråstreg,skarnsstreg,rævestreg,tossestreg,skurkestreg,abekattestreg,talestreg,slyngelstreg,skælmsstreg,replikstreg,nedstreg,skillestreg,opstreg	
4	ener	29	0.00004	29	0	italiener,tjener,tjetjener,wiener,chilener,slovener,forurener,kirketjener,holstener,kammertjener,stumtjener,turkmener,athener,hellener,saracener,ungtjener,gråstener,øjentjener,trettener,gravenstener,lansener,femtener,attener,sekstener,syttener,tre-i-ener,nittener,slesvig-holstener,fjortener	
4	keri	52	0.00004	0	52		fiskeri,fyrværkeri,trykkeri,lækkeri,tovtrækkeri,festfyrværkeri,knivstikkeri,vaskeri,drikkeri,lystfiskeri,bogtrykkeri,pakkeri,krukkeri,snedkeri,overfiskeri,møntvaskeri,pjækkeri,sjuskeri,industrifiskeri,laksefiskeri,fluefiskeri,stikkeri,fuskeri,havfiskeri,dampvaskeri,rovfiskeri,luskeri,optrækkeri,piratfiskeri,garnfiskeri,rejefiskeri,strikkeri,trawlfiskeri,fritænkeri,skruebrækkeri,spytslikkeri,knirkeri,slikkeri,skulkeri,ferskvandsfiskeri,stenfiskeri,lumskeri,bæltfiskeri,spindefiskeri,krogfiskeri,sejtrækkeri,krybfiskeri,valkeri,jaskeri,linefiskeri,sjaskeri,put and take-fiskeri
4	navn	31	0.00004	0	31		efternavn,tilnavn,fornavn,kælenavn,øgenavn,hovednavn,topnavn,dæknavn,kunstnernavn,stednavn,mellemnavn,firmanavn,verdensnavn,gadenavn,pigenavn,brugernavn,kaldenavn,slægtsnavn,personnavn,drengenavn,egennavn,fællesnavn,kvindenavn,artsnavn,døbenavn,marknavn,mandsnavn,giftenavn,trivialnavn,købenavn,sen-navn
4	eser	22	0.00004	22	0	kineser,tuneser,libaneser,vietnameser,indoneser,ghaneser,nepaleser,senegaleser,congoleser,milaneser,malteser,pekingeser,singaleser,divaneser,siameser,havanneser,togoleser,irokeser,gaboneser,ceyloneser,asseneser,sanmarineser	
4	tent	28	0.00004	27	1	assistent,politiassistent,kriminalassistent,kontorassistent,rengøringsassistent,undervisningsassistent,klinikassistent,husassistent,butiksassistent,køkkenassistent,kasseassistent,biblioteksassistent,kontrolassistent,plejeassistent,toldassistent,kommuneassistent,bilassistent,socialassistent,tilsynsassistent,kommittent,fyrassistent,receptionsassistent,sygeplejeassistent,emittent,social- og sundhedsassistent,pønitent,SOSU-assistent	patent
4	tegn	41	0.00004	0	41		spørgsmålstegn,kendetegn,vartegn,lighedstegn,fortegn,kærtegn,udråbstegn,sundhedstegn,livstegn,jagttegn,skrifttegn,sygdomstegn,anførselstegn,citationstegn,fisketegn,hundetegn,træthedstegn,duelighedstegn,jærtegn,dødstegn,aftegn,sejrstegn,skilletegn,nattegn,minustegn,accenttegn,gradstegn,plustegn,taltegn,jokertegn,V-tegn,opløsningstegn,punkttegn,rodtegn,vinkelanførselstegn,baltegn,gangetegn,interpunktionstegn,korrekturtegn,et-tegn,blanktegn
4	iner	46	0.00004	46	0	container,entertainer,ukrainer,argentiner,berliner,retsmediciner,rabbiner,diner,overrabbiner,filippiner,mediciner,aboriginer,montenegriner,libertiner,paramediciner,eyeliner,dalmatiner,mariner,zeppeliner,krydsfiner,liner,latiner,finer,arbejdsmediciner,florentiner,bahrainer,inliner,jakobiner,liechtensteiner,glascontainer,benediktiner,idrætsmediciner,biomediciner,burkiner,aleksandriner,infektionsmediciner,kretiner,augustiner,birgittiner,kapuciner,neuruppiner,beniner,hercegoviner,levantiner,abessiner,cargoliner	
4	stat	20	0.00004	20	0	delstat,nationalstat,retsstat,forbundsstat,østat,politistat,termostat,slyngelstat,småstat,oliestat,fotostat,helstat,lydstat,vasalstat,fristat,satellitstat,randstat,hofstat,reostat,arabstat	
4	atør	28	0.00004	28	0	amatør,restauratør,observatør,operatør,installatør,provokatør,akkompagnatør,translatør,navigatør,kollaboratør,kreatør,dekoratør,elinstallatør,reparatør,blomsterdekoratør,innovatør,stukkatør,filmoperatør,trafikinformatør,isolatør,elektroinstallatør,informatør,tasteoperatør,demonstratør,ventilatør,destillatør,renovatør,kooperatør	
4	kost	23	0.00004	23	0	frokost,julefrokost,hverdagskost,påskefrokost,smalkost,helsekost,råkost,skånekost,husmandskost,fejekost,friskost,arbejdsfrokost,støvekost,tørkost,fuldkost,fattigmandskost,hvidtekost,kalkkost,mandefrokost,tjærekost,blomsterkost,sultekost,elementarkost	
4	arat	25	0.00004	1	24	karat	apparat,præparat,høreapparat,kasseapparat,produktionsapparat,partiapparat,tælleapparat,fotografiapparat,bevægeapparat,varmeapparat,sanseapparat,noteapparat,hormonpræparat,kaldeapparat,gasapparat,ringeapparat,filmapparat,spritapparat,induktionsapparat,sulfapræparat,TV-apparat,tastaturapparat,stavmassageapparat,ildslukningsapparat
4	vist	22	0.00004	21	1	aktivist,kvist,tvist,lingvist,naivist,kollektivist,reservist,konstruktivist,positivist,ørentvist,relativist,socialkonstruktivist,fauvist,slavist,sociolingvist,recidivist,skandinavist,datalingvist,primitivist,ventrilokvist,psykolingvist	tvist
4	skat	33	0.00004	33	0	topskat,ejendomsskat,indkomstskat,marginalskat,kommuneskat,kirkeskat,bruttoskat,personskat,bundskat,sangskat,restskat,formueskat,særskat,muskat,kulturskat,kunstskat,kildeskat,statsskat,jordskat,grundskat,huskat,vejskat,forskudsskat,forbrugsskat,kapitalvindingsskat,slutskat,kopskat,giftskat,proportionalskat,punktskat,majmånedskat,A-skat,B-skat	
4	iger	23	0.00004	22	1	tiger,kriger,østriger,sydslesviger,bjergbestiger,afviger,nejsiger,smiger,koldkriger,brunsviger,slesviger,jasiger,landssviger,nordslesviger,sandsiger,fremmedkriger,sniger,indsiger,skriger,spiger,kongetiger,lemviger	spiger
4	abel	25	0.00004	21	4	tabel,stabel,fabel,sabel,konstabel,label,snabel,vabel,variabel,mirabel,krumsabel,parabel,brændestabel,tidstabel,inkunabel,klokkestabel,dyrefabel,flyverkonstabel,invariabel,gangetabel,bræddestabel	kabel,label,lyslederkabel,telekabel
4	appe	20	0.00004	20	0	trappe,mappe,kappe,rulletrappe,iskappe,bagtrappe,vindeltrappe,hovedtrappe,køkkentrappe,brandtrappe,dokumentmappe,attachémappe,fisketrappe,slængkappe,hælkappe,samlemappe,fortrappe,musetrappe,spindeltrappe,gardinkappe	
4	brev	33	0.00004	0	33		læserbrev,nyhedsbrev,pantebrev,svendebrev,gældsbrev,gækkebrev,kærestebrev,ejerpantebrev,hyrdebrev,næringsbrev,takkebrev,følgebrev,svarbrev,sælgerpantebrev,kædebrev,gavebrev,rykkerbrev,afladsbrev,tebrev,kongebrev,økonomibrev,borgerbrev,fragtbrev,skadesløsbrev,ekspresbrev,lærebrev,lydbrev,bilbrev,B-brev,e-brev,værdibrev,poste restante-brev,A-brev
4	erum	29	0.00004	1	28	trummerum	bagagerum,råderum,serum,kirkerum,pusterum,spillerum,fixerum,handskerum,baderum,albuerum,bederum,kølerum,prøverum,legerum,manøvrerum,hjerterum,vaskerum,uderum,handlerum,sømmerum,venterum,fryserum,skyllerum,skillerum,sandhedsserum,puslerum,backstagerum,blodserum
4	rker	20	0.00004	20	0	håndværker,kunsthåndværker,forstærker,newyorker,perker,dyrker,bygningshåndværker,fyrværker,soldyrker,smagsforstærker,knoldesparker,agerdyrker,speedmarker,frederiksværker,byggehåndværker,forforstærker,marker,fetichdyrker,slaveforstærker,kanalforstærker	
4	ragt	33	0.00003	33	0	dragt,foragt,pragt,fragt,klædedragt,badedragt,kedeldragt,flyverdragt,tragt,træningsdragt,våddragt,folkedragt,spadseredragt,nationaldragt,heldragt,dødsforagt,fjerdragt,luftfragt,stemmepragt,buksedragt,fangedragt,joggingdragt,farvepragt,selvforagt,sparkedragt,dykkerdragt,overlevelsesdragt,festdragt,mandsdragt,natdragt,kravledragt,hjemmedragt,tvedragt	
4	skop	25	0.00003	2	23	biskop,ærkebiskop	mikroskop,teleskop,horoskop,kalejdoskop,stetoskop,periskop,endoskop,oscilloskop,gyroskop,gastroskop,stereoskop,spektroskop,stroboskop,bronkoskop,otoskop,laryngoskop,takistoskop,embryoskop,episkop,elektroskop,galvanoskop,epidiaskop,rektoskop
4	øver	23	0.00003	21	2	røver,udøver,bankrøver,sørøver,sportsudøver,firkløver,trekløver,kløver,hjemmerøver,landevejsrøver,forstøver,stratenrøver,rødkløver,tidrøver,ordkløver,støver,kassebedrøver,møver,stenkløver,alsikekløver,hårkløver	firkløver,trekløver
4	unge	25	0.00003	25	0	tunge,lunge,lounge,junge,rygerlunge,grunge,fugleunge,rødtunge,gøgeunge,søtunge,ulveunge,årsunge,horeunge,mælkejunge,stenlunge,kaninunge,svaneunge,oksetunge,kattetunge,lårtunge,bagtunge,troldeunge,støvlunge,midttunge,fortunge	
4	kift	20	0.00003	0	20		skift,gearskift,paradigmeskift,sceneskift,navneskift,stilskift,temposkift,holdningsskift,bleskift,stemningsskift,karriereskift,skoleskift,treholdsskift,olieskift,toholdsskift,linjeskift,hjulskift,lægeskift,omskift,treskift
4	æppe	25	0.00003	2	23	skæppe,skræppe	tæppe,gulvtæppe,jerntæppe,bagtæppe,kludetæppe,sengetæppe,billedtæppe,vægtæppe,vattæppe,fortæppe,bedetæppe,slumretæppe,ryatæppe,kelimtæppe,brandtæppe,kokostæppe,hyrdetæppe,axminstertæppe,duntæppe,vendetæppe,væg til væg-tæppe,berbertæppe,wiltontæppe
4	skib	33	0.00003	0	33		flagskib,krigsskib,containerskib,fragtskib,rumskib,tankskib,sejlskib,vikingeskib,skoleskib,hangarskib,luftskib,passagerskib,inspektionsskib,dampskib,slagskib,moderskib,søsterskib,køleskib,kirkeskib,orlogsskib,fyrskib,miljøskib,sørøverskib,fiskeskib,langskib,motorskib,hotelskib,agterskib,smuglerskib,tværskib,roll-on-roll-off-skib,koffardiskib,fuldskib
4	ampe	29	0.00003	29	0	lampe,rampe,krampe,advarselslampe,trampe,pandelampe,glødelampe,bordlampe,standerlampe,petroleumslampe,læselampe,stivkrampe,halogenlampe,arkitektlampe,tranlampe,kontrollampe,klampe,skrivekrampe,læsserampe,blæselampe,vågelampe,loftlampe,glimlampe,kulbuelampe,buelampe,alabastlampe,kiplampe,klemlampe,stålampe	
4	træk	33	0.00003	1	32	gennemtræk	stræk,optræk,modtræk,fællestræk,firehjulstræk,karaktertræk,betræk,udtræk,skuldertræk,hovedtræk,overtræk,gennemtræk,antræk,læderindtræk,navnetræk,personlighedstræk,aftræk,skaktræk,indtræk,særtræk,dynebetræk,snoretræk,fugletræk,pudebetræk,skattetræk,kædetræk,sejtræk,undertræk,remtræk,sukkerovertræk,underbetræk,skånebetræk
4	fart	26	0.00003	26	0	topfart,luftfart,søfart,skibsfart,overfart,medfart,forbifart,afart,rumfart,færgefart,langfart,pendulfart,valfart,rutefart,raketfart,himmelfart,rekordfart,sneglefart,nedfart,rundfart,bådfart,gennemfart,slædefart,kystfart,trampfart,koffardifart	
4	sser	28	0.00003	28	0	russer,passer,dyrepasser,strisser,hviderusser,nasser,tankpasser,tresser,oppasser,preusser,børnepasser,telefonpasser,afpresser,papirnusser,misser,saftpresser,sygepasser,fyrpasser,pengeafpresser,frontlæsser,hvidløgspresser,brevpresser,kedelpasser,citronpresser,maskinpasser,hjemmehosser,aflæsser,presser	
4	post	27	0.00003	27	0	aktiepost,ministerpost,tillidspost,præsidentpost,kompost,chefpost,ripost,forpost,gældspost,udkigspost,flaskepost,vagtpost,uriaspost,udpost,pakkepost,retrætepost,lyttepost,kommandopost,vandpost,luftpost,rørpost,kurerpost,blokpost,A-post,e-post,B-post,jobspost	
4	vægt	41	0.00003	41	0	overvægt,hovedvægt,modvægt,ligevægt,egenvægt,totalvægt,sværvægt,weltervægt,dødvægt,undervægt,letvægt,mellemvægt,badevægt,fødselsvægt,håndvægt,letsværvægt,bantamvægt,letweltervægt,uligevægt,guldvægt,fjervægt,letmellemvægt,fluevægt,cruiservægt,supersværvægt,køkkenvægt,kontravægt,slagtevægt,sindsligevægt,brevvægt,letfluevægt,brovægt,fjedervægt,bismervægt,rumvægt,skålvægt,bruttovægt,skydelodsvægt,stangvægt,decimalvægt,flydevægt	
4	pper	47	0.00003	47	0	stopper,skipper,afhopper,plæneklipper,kidnapper,stripper,slapper,fiskeskipper,hiphopper,klipper,flipper,rygklapper,skihopper,bagstopper,filmklipper,chopper,klapper,tipper,bipper,fluesnapper,dørstopper,kystskipper,kuponklipper,bogdropper,sætteskipper,rotorklipper,forstopper,negleklipper,zapper,svupper,papirklipper,egotripper,øltapper,tapper,græsklipper,flueknepper,frøsnapper,opstopper,standupper,indhopper,tre i en-negleklipper,handicapper,namedropper,vintapper,skubopper,desktopper,knabstrupper	
4	evne	27	0.00003	27	0	konkurrenceevne,revne,ydeevne,erhvervsevne,lederevne,funktionsevne,bæreevne,indlæringsevne,fatteevne,lasteevne,reaktionsevne,åndsevne,læseevne,sugeevne,skaberevne,synsevne,handleevne,tænkeevne,spireevne,fremstillingsevne,refleksionsevne,udtryksevne,bageevne,føleevne,ledeevne,virkeevne,strækevne	
4	bånd	46	0.00003	1	45	klubånd	samlebånd,armbånd,bredbånd,smilebånd,videobånd,stemmebånd,kassettebånd,ledbånd,korsbånd,løbebånd,snørebånd,halsbånd,stavnsbånd,transportbånd,målebånd,pandebånd,lydbånd,tungebånd,demobånd,hårbånd,strømpebånd,bindebånd,tøndebånd,råbånd,sognebånd,skråbånd,gummibånd,magnetbånd,farvebånd,gavebånd,klisterbånd,velcrobånd,neglebånd,hanebånd,kantbånd,elastikbånd,slibebånd,isolerbånd,hulbånd,trillebånd,klæbebånd,hosebånd,kodebånd,burrebånd,kapitælbånd
4	salg	22	0.00003	0	22		billetsalg,udsalg,frasalg,detailsalg,forsalg,videresalg,løssalg,lagersalg,mersalg,januarudsalg,tvangssalg,dørsalg,apoteksudsalg,styksalg,håndkøbsudsalg,gensalg,bortsalg,oversalg,katalogsalg,undersalg,slutsalg,slagteriudsalg
4	vejr	25	0.00003	0	25		regnvejr,uvejr,stormvejr,sommervejr,snevejr,vintervejr,tørvejr,tordenvejr,blæsevejr,gråvejr,frostvejr,solskinsvejr,forårsvejr,tøvejr,efterårsvejr,møgvejr,mundsvejr,haglvejr,bygevejr,aprilsvejr,magsvejr,opholdsvejr,ruskvejr,fygevejr,grødevejr
4	olie	38	0.00003	36	2	olivenolie,råolie,dieselolie,folie,fyringsolie,rapsolie,fiskeolie,alufolie,linolie,jomfruolivenolie,smøreolie,spildolie,fuelolie,kaprifolie,solsikkeolie,sololie,spiseolie,gasolie,sojaolie,jomfruolie,bioolie,brændselsolie,hydraulikolie,rosenolie,paraffinolie,salatolie,skæreolie,fuselolie,terpentinolie,bergamotolie,kalmusolie,ricinusolie,nellikeolie,kamferolie,kommenolie,harpiksolie	folie,alufolie
4	etræ	24	0.00003	0	24		juletræ,egetræ,bøgetræ,fyrretræ,nåletræ,birketræ,elmetræ,piletræ,pæretræ,asketræ,palmetræ,kastanjetræ,lærketræ,blommetræ,klatretræ,nøddetræ,elletræ,endetræ,kvædetræ,abetræ,tørstetræ,fugleøjetræ,kragetræ,hængetræ
4	iser	20	0.00003	20	0	underviser,portugiser,vejviser,waliser,pariser,viser,fundraiser,marskandiser,rundviser,friser,fremviser,kirgiser,omviser,sekundviser,nummerviser,minutviser,foreviser,timeviser,overspiser,trøstespiser	
4	sang	28	0.00003	28	0	fællessang,opsang,popsang,nationalsang,korsang,slagsang,klagesang,børnesang,salmesang,aftensang,folkesang,lovsang,titelsang,svanesang,skønsang,protestsang,fædrelandssang,festsang,solosang,gospelsang,alsang,godnatsang,rapsang,vekselsang,scatsang,pisang,rundesang,refrænsang	
4	oder	27	0.00002	18	9	broder,jordemoder,livmoder,gråbroder,dekoder,sortebroder,formoder,våbenbroder,blodbroder,stammoder,skydebroder,fostbroder,lægbroder,rugemoder,barnemoder,afkoder,byldemoder,moder	foder,fiskefoder,kraftfoder,tørfoder,hundefoder,grovfoder,fuldfoder,grønfoder,presfoder
4	værn	20	0.00002	5	15	kværn,peberkværn,kompostkværn,affaldskværn,saltkværn	søværn,hjemmeværn,brandværn,autoværn,vagtværn,høreværn,dyreværn,børneværn,luftværn,brystværn,panserværn,landeværn,raketværn,øjenværn,bedriftsværn
4	vagt	23	0.00002	23	0	livvagt,lægevagt,nattevagt,dommervagt,sikkerhedsvagt,døgnvagt,kystvagt,aftenvagt,tilkaldevagt,gårdvagt,advokatvagt,brandvagt,dagvagt,telefonvagt,brovagt,æresvagt,bagvagt,skildvagt,strejkevagt,hundevagt,frivagt,forvagt,p-vagt	
4	otte	26	0.00002	26	0	rotte,skotte,grotte,potte,jydepotte,urtepotte,lotte,culotte,tepotte,lydpotte,natpotte,gnavpotte,kokotte,kirkerotte,vandrotte,pungrotte,bisamrotte,karotte,gavotte,rumlepotte,hotelrotte,bæverrotte,chamotte,garrotte,faraorotte,moskusrotte	
4	æder	28	0.00002	19	9	hæder,stedfortræder,forræder,landsforræder,lovovertræder,planteæder,misdæder,kødæder,overtræder,påklæder,menneskeæder,grovæder,ådselæder,sengevæder,insektæder,biæder,højforræder,bælgetræder,vandtræder	læder,viskelæder,kernelæder,overlæder,mundlæder,sålelæder,gyldenlæder,bøffellæder,svinelæder
4	ebog	30	0.00002	30	0	kogebog,tegnebog,børnebog,lærebog,drejebog,salmebog,ordrebog,samtalebog,rejsebog,gæstebog,kirkebog,lommebog,læsebog,adressebog,skolebog,malebog,grønspættebog,dødebog,regnebog,jordebog,pegebog,kassebog,tidebog,visebog,kladdebog,stilebog,evangeliebog,Mosebog,noterebog,øvebog	
4	stil	23	0.00002	22	1	livsstil,skrivestil,fristil,pastil,halspastil,kancellistil,rokokostil,rundbuestil,lakridspastil,klunkestil,referatstil,telegramstil,bygningsstil,postil,almuestil,pistil,saltpastil,biedermeierstil,spidsbuestil,salmiakpastil,lapidarstil,art deco-stil	tekstil
4	etur	20	0.00002	20	0	køretur,vandretur,løbetur,spadseretur,fisketur,travetur,ridetur,slentretur,hedetur,hyttetur,svedetur,retur,stroppetur,rystetur,kælketur,pakketur,kanetur,mandetur,tur-retur,appretur	
4	æger	21	0.00002	16	5	jæger,skørtejæger,autografjæger,lykkejæger,pelsjæger,hovedjæger,strandjæger,tilbudsjæger,totenschlæger,brandbæger,faldskærmsjæger,profitjæger,hindebæger,tandbæger,nålebæger,blærebæger	bæger,askebæger,æggebæger,raflebæger,målebæger
4	amin	23	0.00002	8	15	amfetamin,kamin,dopamin,benjamin,metamfetamin,springbalsamin,kloramin,balsamin	vitamin,amfetamin,dopamin,melamin,antihistamin,histamin,metamfetamin,nitrosamin,kloramin,E-vitamin,A-vitamin,K-vitamin,C-vitamin,D-vitamin,B-vitamin
4	ette	33	0.00002	31	2	lette,slette,statuette,operette,diskette,courgette,etikette,brunette,kassette,højslette,baguette,vinaigrette,plakette,pipette,videokassette,georgette,suffragette,kokette,musette,rillette,novellette,ylette,palmette,cuvette,båndkassette,soubrette,jamborette,crepe georgette,reinette,eau de toilette,burette	toilette,pianette
4	tist	29	0.00002	28	1	artist,trompetist,statist,separatist,autist,klarinettist,baptist,cirkusartist,gratist,kommanditist,librettist,adventist,spiritist,pietist,privatist,fagottist,kornettist,okkultist,syvendedagsadventist,defaitist,fløjtist,konkretist,absolutist,obskurantist,batist,esperantist,elitist,pamfletist	batist
4	kage	46	0.00002	46	0	pandekage,lagkage,småkage,lækage,kransekage,chokoladekage,moderkage,æggekage,rævekage,brunkage,honningkage,sandkage,huskekage,konditorkage,flødekage,islagkage,iskage,kiksekage,skærekage,smørkage,jødekage,tørkage,napoleonskage,ostekage,drømmekage,klatkage,madpandekage,marmorkage,søsterkage,othellolagkage,sojakage,kokage,flæskeæggekage,krydderkage,oliekage,foderkage,formkage,othellokage,plumkage,bikage,astakage,brækage,klassens time-kage,håkonskage,rubinsteinkage,chokokage	
4	alat	22	0.00002	21	1	salat,kartoffelsalat,agurkesalat,frugtsalat,pastasalat,tomatsalat,julesalat,hønsesalat,icebergsalat,sildesalat,karrysalat,hovedsalat,kyllingesalat,feldsalat,romainesalat,råkostsalat,waldorfsalat,hummersalat,cæsarsalat,frisésalat,radicchiosalat	ftalat
4	brød	45	0.00002	1	44	øllebrød	rugbrød,smørrebrød,levebrød,franskbrød,wienerbrød,snobrød,knækbrød,hvedebrød,pitabrød,toastbrød,fladbrød,grovbrød,sandwichbrød,landbrød,marcipanbrød,pølsebrød,fuldkornsbrød,surbrød,kuvertbrød,studenterbrød,sigtebrød,nådsensbrød,formbrød,landgangsbrød,kvædebrød,finskbrød,trekornsbrød,kernerugbrød,grahamsbrød,klidbrød,rosinbrød,ciabattabrød,skuebrød,johannesbrød,rosenbrød,focacciabrød,filonebrød,bibrød,sesambrød,birkesbrød,nanbrød,sukkerbrød,walesbrød,glutenbrød
4	nker	21	0.00002	17	4	tænker,tanker,bunker,punker,supertanker,krænker,dranker,junker,fritænker,franker,kammerjunker,stinker,tæppebanker,kvartalsdranker,gastanker,cyberpunker,chanker	anker,drivanker,varpanker,hækanker
4	rred	21	0.00002	9	12	ørred,havørred,regnbueørred,bækørred,fjeldørred,lakseørred,inderred,yderred,damørred	lærred,herred,sækkelærred,hørlærred,lagenlærred,ostelærred,smergellærred,silkelærred,malerlærred,tvistlærred,bredlærred,stræklærred
4	trin	24	0.00002	4	20	doktrin,latrin,citrin,dekstrin	optrin,klassetrin,fejltrin,fortrin,dansetrin,trappetrin,dørtrin,mellemtrin,udviklingstrin,løntrin,alderstrin,latrin,fodtrin,grundtrin,rakettrin,stødtrin,halvtonetrin,tonetrin,heltonetrin,studietrin
4	ømme	20	0.00002	1	19	tømme	omdømme,herredømme,kongedømme,overherredømme,hertugdømme,kejserdømme,fyrstedømme,bispedømme,pavedømme,storhertugdømme,præstedømme,sheikdømme,eneherredømme,voldsherredømme,kurfyrstendømme,enevoldsherredømme,tsardømme,jarledømme,storfyrstedømme
4	lter	24	0.00002	11	13	balter,forvalter,snylter,kelter,shelter,lagerforvalter,godsforvalter,materielforvalter,materialeforvalter,psalter,anholter	alter,filter,partikelfilter,shelter,husalter,luftfilter,højalter,spamfilter,kulfilter,solfilter,støjfilter,fløjalter,gulfilter
4	ugle	23	0.00002	23	0	kugle,halvkugle,krystalkugle,kanonkugle,krudtugle,platugle,slørugle,natugle,hornugle,romkugle,billardkugle,sneugle,mølkugle,marmorkugle,himmelkugle,høgeugle,riffelkugle,kroketkugle,perleugle,revolverkugle,laplandsugle,tårnugle,dum-dum-kugle	
4	mper	23	0.00002	23	0	dæmper,frihedskæmper,autocamper,forkæmper,frontkæmper,støddæmper,pamper,menneskerettighedsforkæmper,damper,jumper,lyddæmper,hjuldamper,lysdæmper,klimaforkæmper,medkæmper,dumper,femkæmper,tikæmper,sandpumper,stamper,stymper,støjdæmper,trampdamper	
4	stav	20	0.00002	15	5	tryllestav,politistav,skistav,tiggerstav,hockeystav,bispestav,hyrdestav,gulerodsstav,p-stav,tøndestav,krumstav,gærdestav,æskulapstav,agurkestav,jakobsstav	bogstav,forbogstav,blokbogstav,kendingsbogstav,bindebogstav
4	vind	26	0.00002	21	5	medvind,modvind,vestenvind,sidevind,hvirvelvind,østenvind,solvind,kastevind,nordenvind,pålandsvind,fralandsvind,stormvind,passatvind,opvind,trækvind,søndenvind,nordvestenvind,sydvestenvind,nordøstenvind,avind,sydøstenvind	gevind,iltsvind,svind,muskelsvind,glavind
4	tang	36	0.00002	36	0	stang,flagstang,løftestang,vognstang,fiskestang,mustang,orangutang,gearstang,ildtang,tandstang,vægtstang,gardinstang,blæretang,saltstang,majstang,rørtang,knibtang,teltstang,plejlstang,sukkertang,målstang,bidetang,rumsterstang,bændeltang,figenstang,borgmesterstang,hultang,frugtstang,papegøjetang,fladtang,sargassotang,walesstang,universaltang,rotang,niptang,bramstang	
4	fugl	48	0.00002	48	0	sommerfugl,rovfugl,trækfugl,sangfugl,påfugl,guldfugl,kanariefugl,ynglefugl,vadefugl,edderfugl,spillefugl,urfugl,spøgefugl,dagsommerfugl,isfugl,ulykkesfugl,andefugl,svømmefugl,kragefugl,kålsommerfugl,pipfugl,spurvefugl,hønsefugl,standfugl,vandrefugl,hærfugl,vildfugl,citronsommerfugl,fregatfugl,silkesommerfugl,spottefugl,gejrfugl,alkefugl,næsehornsfugl,bynkefugl,kramsfugl,stormfugl,galgenfugl,væverfugl,strudsefugl,brokfugl,skrigefugl,storkefugl,pomeransfugl,sekretærfugl,harlekinsommerfugl,strejffugl,risfugl	
4	jord	23	0.00002	23	0	fjord,landjord,muldjord,lerjord,sandjord,markjord,agerjord,hjord,marginaljord,gjord,råjord,inderfjord,frijord,pløjejord,fyldjord,grønjord,buggjord,fædrenejord,brunjord,podsoljord,porcelænsjord,klægjord,valkejord	
4	rapi	22	0.00002	22	0	terapi,kemoterapi,fysioterapi,psykoterapi,genterapi,zoneterapi,parterapi,samtaleterapi,gruppeterapi,adfærdsterapi,musikterapi,beskæftigelsesterapi,ergoterapi,lysterapi,aromaterapi,gestaltterapi,fodterapi,kropsterapi,radioterapi,sorgterapi,primalterapi,bioterapi	
4	hund	35	0.00002	35	0	vagthund,kamphund,gravhund,politihund,svinehund,mårhund,schæferhund,jagthund,muskelhund,førerhund,slædehund,skødehund,sporhund,hanhund,puddelhund,vandhund,bombehund,blodhund,hønsehund,hunhund,ulvehund,ølhund,slagterhund,lænkehund,fårehund,sælhund,sanktbernhardshund,vovhund,præriehund,spidshund,tævehund,vogterhund,pladshund,svejshund,grævlingehund	
4	time	22	0.00002	22	0	dagtime,stime,nattetime,undervisningstime,primetime,mandetime,ulvetime,enetime,centime,skoletime,klokketime,ragtime,fritime,hyrdetime,fiskestime,overtime,sildestime,deletime,katedertime,kilowatt-time,estime,watt-time	
4	vamp	20	0.00002	20	0	svamp,skimmelsvamp,fluesvamp,gærsvamp,fodsvamp,hussvamp,karljohansvamp,tavlesvamp,hatsvamp,fyrsvamp,rustsvamp,rådsvamp,poresvamp,stinksvamp,skivesvamp,viftesvamp,trøffelsvamp,blomkålssvamp,vingesvamp,brandsvamp	
4	sing	20	0.00002	19	1	lussing,dressing,leasing,messing,samsing,fundraising,alsing,ising,fjæsing,salatdressing,skærising,franchising,shortpassing,thousand island-dressing,olie-eddike-dressing,odsing,parsing,hyssing,essing	messing
4	kkel	25	0.00001	23	2	fakkel,sokkel,stakkel,pukkel,knokkel,kakkel,kontinentalsokkel,fastlandssokkel,pumpernikkel,vikkel,kluddermikkel,granitsokkel,skvatmikkel,sjækkel,svinemikkel,bukkel,havefakkel,svikkel,valutapukkel,våsemikkel,somikkel,sjuskemikkel,tudemikkel	nikkel,kobbernikkel
4	ulle	20	0.00001	20	0	rulle,mulle,køkkenrulle,dulle,forårsrulle,bandbulle,krusedulle,kagerulle,filmrulle,malerrulle,bulle,pulle,torarulle,strygerulle,durumrulle,trådrulle,pavebulle,tvetulle,tulle,fnugrulle	
4	kind	21	0.00001	1	20	ferskenkind	skind,rykind,sælskind,ruskind,lammeskind,slangeskind,gedeskind,fåreskind,bjørneskind,tigerskind,ræveskind,krokodilleskind,vaskeskind,fiskeskind,svineskind,pølseskind,nigerskind,molskind,elsdyrskind,skødeskind
4	auce	20	0.00001	20	0	sauce,tomatsauce,rødvinssauce,bearnaisesauce,chokoladesauce,kirsebærsauce,kødsauce,sennepssauce,persillesauce,skysauce,smørsauce,bechamelsauce,østerssauce,karrysauce,hollandaisesauce,champignonsauce,kaperssauce,rævesauce,løgsauce,bordelaisesauce	
4	pose	21	0.00001	21	0	plasticpose,sovepose,plastpose,lønningspose,godtepose,mølpose,bærepose,skraldepose,papirspose,ispose,mulepose,ligpose,tepose,papirpose,stegepose,vindpose,lagenpose,kørepose,kolostomipose,kæbepose,fjerpose	
4	ider	24	0.00001	24	0	outsider,skovrider,insider,cider,slider,berider,glider,stenbider,udsmider,bænkebider,dødbider,grinebider,medvider,æblecider,paraglider,vrider,skævbider,kernebider,forrider,hangglider,bulbider,ringrider,krybbebider,surfrider	
4	ebær	29	0.00001	13	16	kirsebær,enebær,tranebær,tyttebær,multebær,snebær,galnebær,jødekirsebær,galdebær,bjørnebær,krækkebær,krægebær,fruebær	kirsebær,enebær,tranebær,rønnebær,tyttebær,hyldebær,multebær,snebær,ananaskirsebær,jødekirsebær,dessertkirsebær,fruebær,krægebær,bøllebær,krækkebær,bjørnebær
4	pige	22	0.00001	22	0	barnepige,tjenestepige,stuepige,skolepige,kokkepige,bondepige,brudepige,lillepige,nissepige,syngepige,elverpige,escortpige,glædespige,frelserpige,ungkarlepige,enepige,juhupige,stikirendpige,otteårspige,au pair-pige,folde ud-pige,gogopige	
4	seri	23	0.00001	0	23		raseri,karosseri,sløseri,trakasseri,renseri,causeri,hekseri,griseri,papirnusseri,fiksfakseri,tosseri,kineseri,alfonseri,hønseri,rapseri,lodseri,virtuoseri,kradseri,brasseri,kissemisseri,kontoriusseri,rotisseri,våseri
4	arie	20	0.00001	4	16	koloraturarie,ingridmarie,bravurarie,samarie	scenarie,skrækscenarie,drømmescenarie,akvarie,solarie,terrarie,ingridmarie,seminarie,ovarie,pastoralseminarie,eksperimentarie,ferskvandsakvarie,planetarie,pædagogseminarie,sælarie,delfinarie
4	bræt	31	0.00001	0	31		tegnebræt,springbræt,gulvbræt,instrumentbræt,trinbræt,skærebræt,foderbræt,skakbræt,surfbræt,regnebræt,vaskebræt,strygebræt,spækbræt,hakkebræt,toiletbræt,gribebræt,vippebræt,sternbræt,skærmbræt,profilbræt,forskallingsbræt,smørebræt,bundbræt,pudsebræt,gangbræt,kniplebræt,sejlbræt,forskærerbræt,slibebræt,rivebræt,ærmebræt
4	eben	26	0.00001	0	26		højreben,leben,skinneben,kraveben,venstreben,sideben,stilleben,bukseben,flueben,støtteben,stoleben,vingeben,fiskeben,haleben,nøgleben,kæbeben,hofteben,sildeben,spoleben,næseben,lamseben,ønskeben,pandeben,albueben,isseben,skankeben
4	lant	20	0.00001	20	0	spekulant,kontrollant,brillant,kværulant,duellant,gratulant,boligspekulant,slant,asylant,fabulant,flagellant,simulant,volant,interpellant,grundspekulant,sibilant,appellant,kapitulant,tremulant,dublant	
4	vask	21	0.00001	21	0	håndvask,opvask,hvidvask,hjernevask,køkkenvask,storvask,pengevask,kogevask,hårvask,etagevask,maskinvask,klatvask,forvask,finvask,kulørtvask,klarvask,vådvask,udslagsvask,hedvask,skånevask,skyllevask	
4	sord	20	0.00001	1	19	krydsord	skældsord,tillægsord,ukvemsord,krydsord,plusord,udsagnsord,visdomsord,alvorsord,forholdsord,enstavelsesord,æresord,hånsord,udråbsord,minusord,intetkønsord,tostavelsesord,hjælpeudsagnsord,flerstavelsesord,mådesudsagnsord
4	pind	26	0.00001	20	6	styrepind,strikkepind,slikkepind,pegepind,ispind,spisepind,rorpind,limpind,drillepind,vatpind,pølsepind,rundpind,nærigpind,kløpind,frossenpind,kræsenpind,vrangpind,vissenpind,bærepind,gniepind	spind,opspind,tankespind,edderkoppespind,hjernespind,uldspind
4	mælk	25	0.00001	25	0	modermælk,sødmælk,kærnemælk,kokosmælk,letmælk,skummetmælk,kakaomælk,komælk,tykmælk,minimælk,skolemælk,råmælk,gedemælk,konsummælk,sojamælk,chokolademælk,tørmælk,vortemælk,mandelmælk,rismælk,surmælk,æggemælk,svinemælk,bittermælk,ulvemælk	
4	lære	38	0.00001	37	1	blære,mesterlære,udenadslære,udviklingslære,evolutionslære,galdeblære,hørelære,datalære,urinblære,naturlære,svømmeblære,malerlære,vranglære,tømrerlære,samfundslære,morallære,mængdelære,motorlære,færdselslære,murerlære,arvelighedslære,metodelære,materialelære,skydelære,sproglære,harmonilære,gudelære,perspektivlære,metallære,kostlære,ydrelære,verselære,pastorallære,virksomhedslære,borelære,værkstedslære,ordlære	cirkulære
4	syge	39	0.00001	39	0	sukkersyge,sindssyge,søsyge,fåresyge,elmesyge,roskildesyge,gammelmandssukkersyge,skinsyge,køresyge,dykkersyge,behagesyge,sovesyge,legionærsyge,kyssesyge,pyntesyge,hundesyge,humørsyge,transportsyge,forlystelsessyge,omgangssyge,strålesyge,dømmesyge,månesyge,klovesyge,havesyge,papegøjesyge,herskesyge,luftsyge,trommesyge,hvalpesyge,visnesyge,fuldesyge,præstesyge,mosaiksyge,priksyge,regeresyge,Parkinsons syge,drejesyge,mund- og klovesyge	
4	kniv	29	0.00001	29	0	sparekniv,køkkenkniv,hobbykniv,brødkniv,foldekniv,lommekniv,kokkekniv,springkniv,ragekniv,schweizerkniv,paletkniv,urtekniv,giftekniv,barberkniv,slagterkniv,fiskekniv,filetkniv,papirkniv,skrællekniv,frugtkniv,opsprættekniv,skavekniv,slirekniv,trancherkniv,flænsekniv,opskærekniv,tollekniv,chartreusekniv,raderkniv	
4	fisk	39	0.00001	39	0	guldfisk,hornfisk,fladfisk,hellefisk,klipfisk,tørfisk,tunfisk,sværdfisk,plukfisk,rovfisk,klumpfisk,rødfisk,piratfisk,flyvefisk,ferskvandsfisk,skidtfisk,hvalfisk,sølvfisk,industrifisk,konsumfisk,benfisk,blankfisk,bruskfisk,tudsefisk,sildefisk,agnfisk,stokfisk,kuffertfisk,neonfisk,koteletfisk,sættefisk,savfisk,skyttefisk,rognfisk,sugefisk,vragfisk,gydefisk,dybvandsfisk,klatrefisk	
4	syre	32	0.00001	32	0	fedtsyre,aminosyre,garvesyre,kulsyre,mælkesyre,saltsyre,svovlsyre,mavesyre,eddikesyre,acetylsalicylsyre,skovsyre,citronsyre,transfedtsyre,salpetersyre,oxalsyre,blåsyre,urinsyre,nukleinsyre,myresyre,salicylsyre,fosforsyre,smørsyre,borsyre,karbolsyre,kiselsyre,benzoesyre,linolsyre,askorbinsyre,humussyre,valerianesyre,karboxylsyre,druesyre	
4	rmer	23	0.00001	23	0	performer,farmer,transformer,bænkevarmer,himmelstormer,natsværmer,sværmer,vandvarmer,slumstormer,omformer,terrassevarmer,benvarmer,minkfarmer,sjælevarmer,tevarmer,former,aftensværmer,køllesværmer,ligustersværmer,knævarmer,forvarmer,gennemløbsvandvarmer,pelsfarmer	
4	hest	20	0.00001	20	0	kæphest,flodhest,travhest,arbejdshest,læsehest,søhest,ridehest,gyngehest,trækhest,kindhest,fuldblodshest,bryggerhest,araberhest,frederiksborghest,helhest,sengehest,racehest,pruhest,hyphest,halvblodshest	
4	jern	31	0.00001	0	31		håndjern,strygejern,støbejern,rivejern,knojern,brækjern,hakkejern,stemmejern,smedejern,skuffejern,krøllejern,lugejern,råkostjern,vaffeljern,glattejern,plovjern,vinkeljern,spunsjern,rundjern,råjern,skrabejern,pladejern,huljern,rendejern,hyppejern,skavejern,høvlejern,båndjern,stangjern,virkejern,profiljern
4	dans	26	0.00001	26	0	folkedans,mavedans,kædedans,linedans,pardans,standarddans,dødedans,sportsdans,trommedans,kinddans,stepdans,krigsdans,tranedans,runddans,redundans,impedans,nøgendans,konkordans,stopdans,sværddans,sanktvejtsdans,æggedans,turdans,barfodsdans,borddans,kontradans	
4	fejl	22	0.00001	22	0	stavefejl,fodfejl,regnefejl,hjertefejl,skønhedsfejl,trykfejl,dobbeltfejl,slåfejl,begynderfejl,kromosomfejl,sjuskefejl,talefejl,bygningsfejl,skrivefejl,tastefejl,funktionsfejl,byggefejl,vævefejl,materialefejl,huskefejl,tegnfejl,oversætterfejl	
4	seng	20	0.00001	20	0	dobbeltseng,sygeseng,køjeseng,himmelseng,ægteseng,ginseng,vandseng,drømmeseng,barneseng,solseng,tremmeseng,feltseng,flodseng,etageseng,sotteseng,kaneseng,halvandenmandsseng,udtræksseng,stolpeseng,prokrustesseng	
4	rose	25	0.00001	25	0	sklerose,neurose,vindrose,fibrose,julerose,osteoporose,stokrose,klitrose,angstneurose,bonderose,cirrose,slyngrose,nekrose,kompasrose,nøkkerose,levercirrose,alperose,buketrose,arteriosklerose,terose,mosrose,pariserrose,remontantrose,tuberose,jerikorose	
4	glas	31	0.00001	1	30	vandglas	vinglas,reagensglas,brilleglas,timeglas,forstørrelsesglas,plexiglas,ølglas,vandglas,krystalglas,drikkeglas,snapseglas,sylteglas,rødvinsglas,spejlglas,cognacglas,bægerglas,henkogningsglas,patentglas,råglas,brændeglas,marieglas,cylinderglas,objektglas,toddyglas,måleglas,monierglas,flerstyrkeglas,flintglas,planglas,rømerglas
4	åler	23	0.00001	22	1	måler,elmåler,landmåler,fartmåler,undermåler,vindmåler,højdemåler,varmemåler,benzinmåler,regnmåler,trykmåler,vinkelmåler,opmåler,afstandsmåler,lysmåler,værdimåler,støjmåler,fugtighedsmåler,gasmåler,dybdemåler,takkemåler,gradmåler	blåler
4	ksel	23	0.00001	20	3	veksel,aksel,bagaksel,knastaksel,kardanaksel,drivaksel,krumtapaksel,skrueaksel,hjulaksel,sekundaveksel,krankaksel,datoveksel,primaveksel,sigtveksel,vognaksel,rataksel,excenteraksel,a vista-veksel,solaveksel,spilaksel	dæksel,kloakdæksel,benzindæksel
4	rium	28	0.00000	0	28		sammensurium,konsistorium,delirium,atrium,vokabularium,natrium,thorium,herbarium,skuffedarium,deuterium,instrumentarium,diplomatarium,proprium,provisorium,barium,kuratorium,cerium,offertorium,kolumbarium,dokumentarium,responsorium,refektorium,vivarium,glosarium,kalendarium,eksaminatorium,suspensorium,yttrium
4	græs	29	0.00000	1	28	engelskgræs	citrongræs,ålegræs,søgræs,ugræs,elefantgræs,kvikgræs,fuglegræs,frøgræs,rajgræs,hjertegræs,fløjlsgræs,halvgræs,rapgræs,senegræs,hundegræs,aksgræs,bjørnegræs,timotégræs,fioringræs,kamgræs,hvenegræs,kanariegræs,espartogræs,stargræs,miliegræs,hestegræs,bævregræs,skavgræs
